GTCTTATTTGATATATCTGGTCCG -> TCTTATTTGATATATCTGGTCCGG
AACCTGAAACCGGTTTATGTACAT -> ACCTGAAACCGGTTTATGTACATA
TACATGGTGTTGCCTGTAACAGAC -> ACATGGTGTTGCCTGTAACAGACT
AATCTGTAGCATGTCCGACGCTTA -> ATCTGTAGCATGTCCGACGCTTAG
ACCTTGAGATCTCGGGGCGAGCGC -> CCTTGAGATCTCGGGGCGAGCGCA
ATGCTGTCCAAGAGCCCTAATCGG -> TGCTGTCCAAGAGCCCTAATCGGA
GCGTAGCGATGCCATACACCACAG -> CGTAGCGATGCCATACACCACAGA
ACTGCGACATACCTTGGACCGGTC -> CTGCGACATACCTTGGACCGGTCG
CCTTGAGAAGTAGCCGTGTATCGT -> CTTGAGAAGTAGCCGTGTATCGTC
GCCACTCCCGGGATCCTCCCGCCA -> CCACTCCCGGGATCCTCCCGCCAT
ACTGCGAGACAATGCGGTTACTCT -> CTGCGAGACAATGCGGTTACTCTC
GTAACAGGTCCTGCTCGCGAGTAA -> TAACAGGTCCTGCTCGCGAGTAAG
TGGCGATGGTAAAAGCTAACCAGC -> GGCGATGGTAAAAGCTAACCAGCG
AGGCACGGAACGACCCACGTATAG -> GGCACGGAACGACCCACGTATAGC
CAATGCGGTTACTCTCGCAGAGTC -> AATGCGGTTACTCTCGCAGAGTCA
AAATATGCTGTCCAAGAGCCCTAA -> AATATGCTGTCCAAGAGCCCTAAT
GGCGTAGCGATGCCATACACCACA -> GCGTAGCGATGCCATACACCACAG
GCGCAATGCTCCTTCGTAAAGAAT -> CGCAATGCTCCTTCGTAAAGAATT
CACAAGCATACACGGTAATCCTAA -> ACAAGCATACACGGTAATCCTAAG
GCGTTTTGGCGCTCCACGGTTATC -> CGTTTTGGCGCTCCACGGTTATCA
GTGCGTACTGATTTCACACCTTCT -> TGCGTACTGATTTCACACCTTCTG
CTAAAATCCTACGAACTAGAGCTG -> TAAAATCCTACGAACTAGAGCTGT
TGGCCTGGGGAACCCATCATTAAA -> GGCCTGGGGAACCCATCATTAAAG
GGATGGCAGCTGGCGTAGCGATGC -> GATGGCAGCTGGCGTAGCGATGCC
CTTGGTAAGTCGATAACTTGTGCA -> TTGGTAAGTCGATAACTTGTGCAG
TCGTCCGCACGTGATTGAATGCTC -> CGTCCGCACGTGATTGAATGCTCC
CAGTTAACGGTGTTATCGGTCCAT -> AGTTAACGGTGTTATCGGTCCATC
TCATGGACACGGGCGTTGGCATGA -> CATGGACACGGGCGTTGGCATGAC
CCGCACGTGATTGAATGCTCCGCG -> CGCACGTGATTGAATGCTCCGCGG
CTAGAAGGGCGTTACACCATGCCA -> TAGAAGGGCGTTACACCATGCCAC
AGGCAATTGGGATGGCAGCTGGCG -> GGCAATTGGGATGGCAGCTGGCGT
TAAAATCCTACGAACTAGAGCTGT -> AAAATCCTACGAACTAGAGCTGTC
ATTCTAGGCTACCCAACGTGATTG -> TTCTAGGCTACCCAACGTGATTGG
ACGGCGTTTGTATATGGAATCAGT -> CGGCGTTTGTATATGGAATCAGTC
TATTAGCGTGTACGGCCTTTCTCG -> ATTAGCGTGTACGGCCTTTCTCGG
AGCCAAACCTTCTAGTAACAGGTC -> GCCAAACCTTCTAGTAACAGGTCC
TTAATTAGTATTCCAAGGAGAGGG -> TAATTAGTATTCCAAGGAGAGGGA
ACTGTTAATCCGGAGTAGCCAAAC -> CTGTTAATCCGGAGTAGCCAAACC
ACCTGAAACCGGTTTATGTACATA -> CCTGAAACCGGTTTATGTACATAT
GCTCGGAAGTCTGTTGTGAGACGA -> CTCGGAAGTCTGTTGTGAGACGAC
GGCGGATGTCTGGTGATTAGATCC -> GCGGATGTCTGGTGATTAGATCCG
TAGAGCTTAACAATATCTCTTACC -> AGAGCTTAACAATATCTCTTACCA
AAACCTTCTAGTAACAGGTCCTGC -> AACCTTCTAGTAACAGGTCCTGCT
TCACACGCGTTTTGGCGCTCCACG -> CACACGCGTTTTGGCGCTCCACGG
TTCCGGTAACCCGGTAGTATATAC -> TCCGGTAACCCGGTAGTATATACC
TAAGACTAGATGATCGACTGCGAG -> AAGACTAGATGATCGACTGCGAGA
GTAACCCGGTAGTATATACCTTGG -> TAACCCGGTAGTATATACCTTGGT
CGTGCTAGCATTCTAGGCTACCCA -> GTGCTAGCATTCTAGGCTACCCAA
CCAAGAGCCCTAATCGGAGCCAGG -> CAAGAGCCCTAATCGGAGCCAGGT
CGGAGTAGCCAAACCTTCTAGTAA -> GGAGTAGCCAAACCTTCTAGTAAC
TCGCAGAGTCATGGACACGGGCGT -> CGCAGAGTCATGGACACGGGCGTT
GGCGTGTCTTTTCAACTATTGTCA -> GCGTGTCTTTTCAACTATTGTCAC
CATAGACATGACCGAATCTGTAGC -> ATAGACATGACCGAATCTGTAGCA
ACTGATTTCACACCTTCTGCTACG -> CTGATTTCACACCTTCTGCTACGG
ATTGGACCGCGGCTCGGAAGTCTG -> TTGGACCGCGGCTCGGAAGTCTGT
TAATCCGGAGTAGCCAAACCTTCT -> AATCCGGAGTAGCCAAACCTTCTA
TGAATGCTCCGCGGCTTGTCTTCT -> GAATGCTCCGCGGCTTGTCTTCTT
ACACGCGTTTTGGCGCTCCACGGT -> CACGCGTTTTGGCGCTCCACGGTT
GTGCTAGCATTCTAGGCTACCCAA -> TGCTAGCATTCTAGGCTACCCAAC
CTTGACCTTGAGATCTCGGGGCGA -> TTGACCTTGAGATCTCGGGGCGAG
CGATTAATTAGTATTCCAAGGAGA -> GATTAATTAGTATTCCAAGGAGAG
GCATTCTAGGCTACCCAACGTGAT -> CATTCTAGGCTACCCAACGTGATT
AATATCTCTTACCATTGGGCTGTA -> ATATCTCTTACCATTGGGCTGTAC
GGTCCATCTTCCTACGAGCCGACC -> GTCCATCTTCCTACGAGCCGACCT
TGTCGTCGCTAAGGGGGCTGGTGG -> GTCGTCGCTAAGGGGGCTGGTGGA
CACCTGTCTTATTTGATATATCTG -> ACCTGTCTTATTTGATATATCTGG
CTAGCATTCTAGGCTACCCAACGT -> TAGCATTCTAGGCTACCCAACGTG
CGAAACTATTAGCGTGTACGGCCT -> GAAACTATTAGCGTGTACGGCCTT
CATGTTCACACGCGTTTTGGCGCT -> ATGTTCACACGCGTTTTGGCGCTC
TGTTAATCCGGAGTAGCCAAACCT -> GTTAATCCGGAGTAGCCAAACCTT
AAGTCGATAACTTGTGCAGGATGA -> AGTCGATAACTTGTGCAGGATGAT
ATACCTTGGTAAGTCGATAACTTG -> TACCTTGGTAAGTCGATAACTTGT
CATCAGCTTAGGTTTGCGCCGCGC -> ATCAGCTTAGGTTTGCGCCGCGCG
ATCTCCTAGCCTAGAAGGGCGTTA -> TCTCCTAGCCTAGAAGGGCGTTAC
CCACAAGCATACACGGTAATCCTA -> CACAAGCATACACGGTAATCCTAA
AGCCAGGTTGACGCGCCGTACACA -> GCCAGGTTGACGCGCCGTACACAC
CTACCCAACGTGATTGGCCTGGGG -> TACCCAACGTGATTGGCCTGGGGA
CGAGCCGACCTCTCCCACAAGCAT -> GAGCCGACCTCTCCCACAAGCATA
TAAGGACTGTGATTCAGCCCATCA -> AAGGACTGTGATTCAGCCCATCAG
TGACGCGCCGTACACACTAGCCCT -> GACGCGCCGTACACACTAGCCCTT
GATTGGACCGCGGCTCGGAAGTCT -> ATTGGACCGCGGCTCGGAAGTCTG
CCACTCCCGGGATCCTCCCGCCAT -> CACTCCCGGGATCCTCCCGCCATG
GACTGCGAGACAATGCGGTTACTC -> ACTGCGAGACAATGCGGTTACTCT
GGAACCCATCATTAAAGTTATGCC -> GAACCCATCATTAAAGTTATGCCA
GGTCCGGCCTTAGGGCTAGTTTAG -> GTCCGGCCTTAGGGCTAGTTTAGC
GGTTATCACCGTCCTGAGCTTGCC -> GTTATCACCGTCCTGAGCTTGCCT
CCTTCTAGTAACAGGTCCTGCTCG -> CTTCTAGTAACAGGTCCTGCTCGC
GACACGGACCAGATGGTTCGTAAT -> ACACGGACCAGATGGTTCGTAATT
TGATTTCACACCTTCTGCTACGGA -> GATTTCACACCTTCTGCTACGGAG
GAGACAACGTGCTAGCATTCTAGG -> AGACAACGTGCTAGCATTCTAGGC
ACGGCTTACTTCCGGTAACCCGGT -> CGGCTTACTTCCGGTAACCCGGTA
CATGGTCTGAGGTAACTCCTACGT -> ATGGTCTGAGGTAACTCCTACGTA
ACGTGTTGCCGTGGCGTGTCTTTT -> CGTGTTGCCGTGGCGTGTCTTTTC
ATACCTTGGACCGGTCGACCAGTC -> TACCTTGGACCGGTCGACCAGTCA
ACAGATGACAGACTAGACTTACGG -> CAGATGACAGACTAGACTTACGGC
TGGATGCACGCGCTGGGATTATGG -> GGATGCACGCGCTGGGATTATGGC
GACTCCGATTAATTAGTATTCCAA -> ACTCCGATTAATTAGTATTCCAAG
GATGCCATACACCACAGAATACGG -> ATGCCATACACCACAGAATACGGC
TCAGCGACACGGACCAGATGGTTC -> CAGCGACACGGACCAGATGGTTCG
ATGGTGTTGCCTGTAACAGACTGC -> TGGTGTTGCCTGTAACAGACTGCA
CATGCCACCATGTTCACACGCGTT -> ATGCCACCATGTTCACACGCGTTT
ACTAGACTTACGGCTTACTTCCGG -> CTAGACTTACGGCTTACTTCCGGT
AAAGGCGGATGTCTGGTGATTAGA -> AAGGCGGATGTCTGGTGATTAGAT
GGTAACCTAAATTGCATGGTCTGA -> GTAACCTAAATTGCATGGTCTGAG
ATGACCGAATCTGTAGCATGTCCG -> TGACCGAATCTGTAGCATGTCCGA
ATACACGGTAATCCTAAGGACTGT -> TACACGGTAATCCTAAGGACTGTG
GTGATTGGCCTGGGGAACCCATCA -> TGATTGGCCTGGGGAACCCATCAT
TGCAGAGACAACGTGCTAGCATTC -> GCAGAGACAACGTGCTAGCATTCT
TGGTGGAGACCGCTGGGTCGTCCG -> GGTGGAGACCGCTGGGTCGTCCGC
GCGGCTTGTCTTCTTTCAGGATAA -> CGGCTTGTCTTCTTTCAGGATAAA
CCGGTATAGCACCTGTCTTATTTG -> CGGTATAGCACCTGTCTTATTTGA
GGTTTATGTACATATGGTAGCTGC -> GTTTATGTACATATGGTAGCTGCT
CTCCACGGTTATCACCGTCCTGAG -> TCCACGGTTATCACCGTCCTGAGC
CTAAATTGCATGGTCTGAGGTAAC -> TAAATTGCATGGTCTGAGGTAACT
GATGACAGACTAGACTTACGGCTT -> ATGACAGACTAGACTTACGGCTTA
GTAGCCGTGTATCGTCAACGTGTT -> TAGCCGTGTATCGTCAACGTGTTG
TTCTCGGAGAGAACCTGAAACCGG -> TCTCGGAGAGAACCTGAAACCGGT
GAATGCTCCGCGGCTTGTCTTCTT -> AATGCTCCGCGGCTTGTCTTCTTT
CCTAAATTGCATGGTCTGAGGTAA -> CTAAATTGCATGGTCTGAGGTAAC
CCATCATTAAAGTTATGCCACTCC -> CATCATTAAAGTTATGCCACTCCC
CCCGAAATATGCTGTCCAAGAGCC -> CCGAAATATGCTGTCCAAGAGCCC
GAGAAGTAGCCGTGTATCGTCAAC -> AGAAGTAGCCGTGTATCGTCAACG
TGGTAAGTCGATAACTTGTGCAGG -> GGTAAGTCGATAACTTGTGCAGGA
GATGCACGCGCTGGGATTATGGCG -> ATGCACGCGCTGGGATTATGGCGA
GCTCTTTATTCCGGTATAGCACCT -> CTCTTTATTCCGGTATAGCACCTG
AATTATCTTACACCATTTTTTCGC -> ATTATCTTACACCATTTTTTCGCA
CCATGGGGTAACCTAAATTGCATG -> CATGGGGTAACCTAAATTGCATGG
TGCTAGCATTCTAGGCTACCCAAC -> GCTAGCATTCTAGGCTACCCAACG
ACCATTGGGCTGTACATCTCCTAG -> CCATTGGGCTGTACATCTCCTAGC
CTGTGATTCAGCCCATCAGCTTAG -> TGTGATTCAGCCCATCAGCTTAGG
CAATGCTCCTTCGTAAAGAATTCA -> AATGCTCCTTCGTAAAGAATTCAC
GCTGTCCAAGAGCCCTAATCGGAG -> CTGTCCAAGAGCCCTAATCGGAGC
CGCGCGGAAGGGTAGGGGACTCCG -> GCGCGGAAGGGTAGGGGACTCCGA
ACTCTTCAGTATACTAAAATCCTA -> CTCTTCAGTATACTAAAATCCTAC
ATGCAGAGACAACGTGCTAGCATT -> TGCAGAGACAACGTGCTAGCATTC
GCCGTGTATCGTCAACGTGTTGCC -> CCGTGTATCGTCAACGTGTTGCCG
TCCGGAGATTGGACCGCGGCTCGG -> CCGGAGATTGGACCGCGGCTCGGA
TACCTTGGTAAGTCGATAACTTGT -> ACCTTGGTAAGTCGATAACTTGTG
GCTTAGTGGATTTAGGGCCCTACA -> CTTAGTGGATTTAGGGCCCTACAT
TTAGATATGCATTCGCCCGAAATA -> TAGATATGCATTCGCCCGAAATAT
AGGGCGTTACACCATGCCACCATG -> GGGCGTTACACCATGCCACCATGT
GGGGAACCCATCATTAAAGTTATG -> GGGAACCCATCATTAAAGTTATGC
GTGTCTTTTCAACTATTGTCACCA -> TGTCTTTTCAACTATTGTCACCAT
AAACCGGTTTATGTACATATGGTA -> AACCGGTTTATGTACATATGGTAG
CCGACGCTTAGTGGATTTAGGGCC -> CGACGCTTAGTGGATTTAGGGCCC
CGAACTAGAGCTGTCAGCGACACG -> GAACTAGAGCTGTCAGCGACACGG
CGAGCGCAATGCTCCTTCGTAAAG -> GAGCGCAATGCTCCTTCGTAAAGA
CCTCACAGATGACAGACTAGACTT -> CTCACAGATGACAGACTAGACTTA
CCATCAGCTTAGGTTTGCGCCGCG -> CATCAGCTTAGGTTTGCGCCGCGC
TGTAACAGACTGCAAGTATCTTAC -> GTAACAGACTGCAAGTATCTTACG
GAGTAAGACTAGATGATCGACTGC -> AGTAAGACTAGATGATCGACTGCG
TCCCACAAGCATACACGGTAATCC -> CCCACAAGCATACACGGTAATCCT
CCGGTAACCCGGTAGTATATACCT -> CGGTAACCCGGTAGTATATACCTT
CAGAATACGGCGTTTGTATATGGA -> AGAATACGGCGTTTGTATATGGAA
CAACGTGTTGCCGTGGCGTGTCTT -> AACGTGTTGCCGTGGCGTGTCTTT
AACTTGTGCAGGATGATTCGGAGC -> ACTTGTGCAGGATGATTCGGAGCC
TTGATATATCTGGTCCGGCCTTAG -> TGATATATCTGGTCCGGCCTTAGG
CGGCTTGTCTTCTTTCAGGATAAA -> GGCTTGTCTTCTTTCAGGATAAAA
GACCGCTGGGTCGTCCGCACGTGA -> ACCGCTGGGTCGTCCGCACGTGAT
ACGAGCCGACCTCTCCCACAAGCA -> CGAGCCGACCTCTCCCACAAGCAT
GTGTTGCCTGTAACAGACTGCAAG -> TGTTGCCTGTAACAGACTGCAAGT
CATTCGCCCGAAATATGCTGTCCA -> ATTCGCCCGAAATATGCTGTCCAA
CTTGAGATCTCGGGGCGAGCGCAA -> TTGAGATCTCGGGGCGAGCGCAAT
CGGTAACCCGGTAGTATATACCTT -> GGTAACCCGGTAGTATATACCTTG
CACCGTCCTGAGCTTGCCTACTGC -> ACCGTCCTGAGCTTGCCTACTGCG
CGCTAAGGGGGCTGGTGGAGACCG -> GCTAAGGGGGCTGGTGGAGACCGC
TACACCACAGAATACGGCGTTTGT -> ACACCACAGAATACGGCGTTTGTA
TATAGCACCTGTCTTATTTGATAT -> ATAGCACCTGTCTTATTTGATATA
GCGTGTCTTTTCAACTATTGTCAC -> CGTGTCTTTTCAACTATTGTCACC
TTACTCTCGCAGAGTCATGGACAC -> TACTCTCGCAGAGTCATGGACACG
GGGCTGTACATCTCCTAGCCTAGA -> GGCTGTACATCTCCTAGCCTAGAA
TGGGGAACCCATCATTAAAGTTAT -> GGGGAACCCATCATTAAAGTTATG
ACGGGCGTTGGCATGACAAAGGCG -> CGGGCGTTGGCATGACAAAGGCGG
GCTGTACATCTCCTAGCCTAGAAG -> CTGTACATCTCCTAGCCTAGAAGG
GTCCGGCCTTAGGGCTAGTTTAGC -> TCCGGCCTTAGGGCTAGTTTAGCT
GCAGCACGGAATGAGAAATCTATG -> CAGCACGGAATGAGAAATCTATGC
ATCAGCTTAGGTTTGCGCCGCGCG -> TCAGCTTAGGTTTGCGCCGCGCGC
CACGCGCTGGGATTATGGCGATGG -> ACGCGCTGGGATTATGGCGATGGT
AAGTTATGCCACTCCCGGGATCCT -> AGTTATGCCACTCCCGGGATCCTC
GAGCGCAATGCTCCTTCGTAAAGA -> AGCGCAATGCTCCTTCGTAAAGAA
GAGCTTAACAATATCTCTTACCAT -> AGCTTAACAATATCTCTTACCATT
ATGGTAAAAGCTAACCAGCGTTCA -> TGGTAAAAGCTAACCAGCGTTCAT
AGCCCTAATCGGAGCCAGGTTGAC -> GCCCTAATCGGAGCCAGGTTGACG
AGTCAAGACGCAAGTGTCGTCGCT -> GTCAAGACGCAAGTGTCGTCGCTA
ACGGAATGAGAAATCTATGCAGAG -> CGGAATGAGAAATCTATGCAGAGA
TCGGAAGTCTGTTGTGAGACGACT -> CGGAAGTCTGTTGTGAGACGACTT
GTGTACGGCCTTTCTCGGAGAGAA -> TGTACGGCCTTTCTCGGAGAGAAC
CTCGGAGAGAACCTGAAACCGGTT -> TCGGAGAGAACCTGAAACCGGTTT
AGTAAGACTAGATGATCGACTGCG -> GTAAGACTAGATGATCGACTGCGA
CGCGGCTCGGAAGTCTGTTGTGAG -> GCGGCTCGGAAGTCTGTTGTGAGA
ACCGTCCTGAGCTTGCCTACTGCG -> CCGTCCTGAGCTTGCCTACTGCGA
AGAAGGGCGTTACACCATGCCACC -> GAAGGGCGTTACACCATGCCACCA
CACGGGCGTTGGCATGACAAAGGC -> ACGGGCGTTGGCATGACAAAGGCG
CTACTGCGACATACCTTGGACCGG -> TACTGCGACATACCTTGGACCGGT
GGTAGCTGCTCTTTATTCCGGTAT -> GTAGCTGCTCTTTATTCCGGTATA
AGACAACGTGCTAGCATTCTAGGC -> GACAACGTGCTAGCATTCTAGGCT
AAGGGGGCTGGTGGAGACCGCTGG -> AGGGGGCTGGTGGAGACCGCTGGG
CTAGATGATCGACTGCGAGACAAT -> TAGATGATCGACTGCGAGACAATG
GGCGTTGGCATGACAAAGGCGGAT -> GCGTTGGCATGACAAAGGCGGATG
GATTTCACACCTTCTGCTACGGAG -> ATTTCACACCTTCTGCTACGGAGA
CCATTTTTTCGCAGTACTAGAGCT -> CATTTTTTCGCAGTACTAGAGCTT
AGCCGACCTCTCCCACAAGCATAC -> GCCGACCTCTCCCACAAGCATACA
TTGTCACCATTTAGGCACGGAACG -> TGTCACCATTTAGGCACGGAACGA
CCATGCCACCATGTTCACACGCGT -> CATGCCACCATGTTCACACGCGTT
CACGGTTATCACCGTCCTGAGCTT -> ACGGTTATCACCGTCCTGAGCTTG
GTACGGCCTTTCTCGGAGAGAACC -> TACGGCCTTTCTCGGAGAGAACCT
AGAGCCCTAATCGGAGCCAGGTTG -> GAGCCCTAATCGGAGCCAGGTTGA
GAAGTAGCCGTGTATCGTCAACGT -> AAGTAGCCGTGTATCGTCAACGTG
GGGTCGTCCGCACGTGATTGAATG -> GGTCGTCCGCACGTGATTGAATGC
CGGTAGTATATACCTTGGTAAGTC -> GGTAGTATATACCTTGGTAAGTCG
ATATATCTGGTCCGGCCTTAGGGC -> TATATCTGGTCCGGCCTTAGGGCT
TTGTGCAGGATGATTCGGAGCCGA -> TGTGCAGGATGATTCGGAGCCGAA
AAGGAGAGGGAGCTGCAGCACGGA -> AGGAGAGGGAGCTGCAGCACGGAA
CGGGCGTTGGCATGACAAAGGCGG -> GGGCGTTGGCATGACAAAGGCGGA
GCCTACTGCGACATACCTTGGACC -> CCTACTGCGACATACCTTGGACCG
ACAGGTTAGATATGCATTCGCCCG -> CAGGTTAGATATGCATTCGCCCGA
TCCTGAGCTTGCCTACTGCGACAT -> CCTGAGCTTGCCTACTGCGACATA
GCTGGTGGAGACCGCTGGGTCGTC -> CTGGTGGAGACCGCTGGGTCGTCC
TATATCCTATGCATGCTTTCGATT -> ATATCCTATGCATGCTTTCGATTG
TGCCACTCCCGGGATCCTCCCGCC -> GCCACTCCCGGGATCCTCCCGCCA
CGTAATTATCTTACACCATTTTTT -> GTAATTATCTTACACCATTTTTTC
TTGTATATGGAATCAGTCGTCGAG -> TGTATATGGAATCAGTCGTCGAGG
TTGGCATGACAAAGGCGGATGTCT -> TGGCATGACAAAGGCGGATGTCTG
TCCTACGAACTAGAGCTGTCAGCG -> CCTACGAACTAGAGCTGTCAGCGA
TTGGCGCTCCACGGTTATCACCGT -> TGGCGCTCCACGGTTATCACCGTC
GAACGACCCACGTATAGCAGACTC -> AACGACCCACGTATAGCAGACTCT
AGACATGACCGAATCTGTAGCATG -> GACATGACCGAATCTGTAGCATGT
TGTCCAAGAGCCCTAATCGGAGCC -> GTCCAAGAGCCCTAATCGGAGCCA
AGACTAGACTTACGGCTTACTTCC -> GACTAGACTTACGGCTTACTTCCG
CGACGCTTAGTGGATTTAGGGCCC -> GACGCTTAGTGGATTTAGGGCCCT
AGCGTGTACGGCCTTTCTCGGAGA -> GCGTGTACGGCCTTTCTCGGAGAG
GTATAGCACCTGTCTTATTTGATA -> TATAGCACCTGTCTTATTTGATAT
TATGCTGTCCAAGAGCCCTAATCG -> ATGCTGTCCAAGAGCCCTAATCGG
TACGTAATGACAGTTAACGGTGTT -> ACGTAATGACAGTTAACGGTGTTA
GGGGGCTGGTGGAGACCGCTGGGT -> GGGGCTGGTGGAGACCGCTGGGTC
GACATGACCGAATCTGTAGCATGT -> ACATGACCGAATCTGTAGCATGTC
ACGAACTAGAGCTGTCAGCGACAC -> CGAACTAGAGCTGTCAGCGACACG
AGCAGACTCTTCAGTATACTAAAA -> GCAGACTCTTCAGTATACTAAAAT
GTGTTGCCGTGGCGTGTCTTTTCA -> TGTTGCCGTGGCGTGTCTTTTCAA
AACGGTGTTATCGGTCCATCTTCC -> ACGGTGTTATCGGTCCATCTTCCT
AGCATACACGGTAATCCTAAGGAC -> GCATACACGGTAATCCTAAGGACT
ACCTCTCCCACAAGCATACACGGT -> CCTCTCCCACAAGCATACACGGTA
CACCATGCCACCATGTTCACACGC -> ACCATGCCACCATGTTCACACGCG
CCGAAATATGCTGTCCAAGAGCCC -> CGAAATATGCTGTCCAAGAGCCCT
ATTGGGCTGTACATCTCCTAGCCT -> TTGGGCTGTACATCTCCTAGCCTA
ACAAGCATACACGGTAATCCTAAG -> CAAGCATACACGGTAATCCTAAGG
ATTTAGGGCCCTACATTCTGGATG -> TTTAGGGCCCTACATTCTGGATGC
TTGGGATGGCAGCTGGCGTAGCGA -> TGGGATGGCAGCTGGCGTAGCGAT
TGGTGATTAGATCCGGAGATTGGA -> GGTGATTAGATCCGGAGATTGGAC
TGGAGACCGCTGGGTCGTCCGCAC -> GGAGACCGCTGGGTCGTCCGCACG
TTTAGGGCCCTACATTCTGGATGC -> TTAGGGCCCTACATTCTGGATGCA
ACTAGATGATCGACTGCGAGACAA -> CTAGATGATCGACTGCGAGACAAT
CTTGGACCGGTCGACCAGTCAAGA -> TTGGACCGGTCGACCAGTCAAGAC
GGAGCTGCAGCACGGAATGAGAAA -> GAGCTGCAGCACGGAATGAGAAAT
ATTTTTTCGCAGTACTAGAGCTTA -> TTTTTTCGCAGTACTAGAGCTTAA
TTCCGGTATAGCACCTGTCTTATT -> TCCGGTATAGCACCTGTCTTATTT
CGACCAGTCAAGACGCAAGTGTCG -> GACCAGTCAAGACGCAAGTGTCGT
GATGGTTCGTAATTATCTTACACC -> ATGGTTCGTAATTATCTTACACCA
ACCGGTCGACCAGTCAAGACGCAA -> CCGGTCGACCAGTCAAGACGCAAG
CGCGCGCGGAAGGGTAGGGGACTC -> GCGCGCGGAAGGGTAGGGGACTCC
CGCTCCACGGTTATCACCGTCCTG -> GCTCCACGGTTATCACCGTCCTGA
ATTAAAGTTATGCCACTCCCGGGA -> TTAAAGTTATGCCACTCCCGGGAT
TCACAGATGACAGACTAGACTTAC -> CACAGATGACAGACTAGACTTACG
AATCCTAAGGACTGTGATTCAGCC -> ATCCTAAGGACTGTGATTCAGCCC
GGAGCCAGGTTGACGCGCCGTACA -> GAGCCAGGTTGACGCGCCGTACAC
AAGTATCTTACGTAATGACAGTTA -> AGTATCTTACGTAATGACAGTTAA
ATTCGCCCGAAATATGCTGTCCAA -> TTCGCCCGAAATATGCTGTCCAAG
CCAGATGGTTCGTAATTATCTTAC -> CAGATGGTTCGTAATTATCTTACA
ACGTATAGCAGACTCTTCAGTATA -> CGTATAGCAGACTCTTCAGTATAC
GAGCTTGCCTACTGCGACATACCT -> AGCTTGCCTACTGCGACATACCTT
GCGCCGCGCGCGGAAGGGTAGGGG -> CGCCGCGCGCGGAAGGGTAGGGGA
AAGGCGGATGTCTGGTGATTAGAT -> AGGCGGATGTCTGGTGATTAGATC
AGAGACAACGTGCTAGCATTCTAG -> GAGACAACGTGCTAGCATTCTAGG
TTATCGGTCCATCTTCCTACGAGC -> TATCGGTCCATCTTCCTACGAGCC
GTTATCACCGTCCTGAGCTTGCCT -> TTATCACCGTCCTGAGCTTGCCTA
GGACCGGTCGACCAGTCAAGACGC -> GACCGGTCGACCAGTCAAGACGCA
TAAAAGCTAACCAGCGTTCATCCT -> AAAAGCTAACCAGCGTTCATCCTC
ATTTGATATATCTGGTCCGGCCTT -> TTTGATATATCTGGTCCGGCCTTA
GAAGGGTAGGGGACTCCGATTAAT -> AAGGGTAGGGGACTCCGATTAATT
CTACGGAGAAAGCCCGTTATATCC -> TACGGAGAAAGCCCGTTATATCCT
AACTATTGTCACCATTTAGGCACG -> ACTATTGTCACCATTTAGGCACGG
TGTCACCATTTAGGCACGGAACGA -> GTCACCATTTAGGCACGGAACGAC
CCTTGAGATCTCGGGGCGAGCGCA -> CTTGAGATCTCGGGGCGAGCGCAA
TCCGGTATAGCACCTGTCTTATTT -> CCGGTATAGCACCTGTCTTATTTG
TTAGTGGATTTAGGGCCCTACATT -> TAGTGGATTTAGGGCCCTACATTC
TTAAAGTTATGCCACTCCCGGGAT -> TAAAGTTATGCCACTCCCGGGATC
TACACGGTAATCCTAAGGACTGTG -> ACACGGTAATCCTAAGGACTGTGA
CCCACGTATAGCAGACTCTTCAGT -> CCACGTATAGCAGACTCTTCAGTA
GCACGGAATGAGAAATCTATGCAG -> CACGGAATGAGAAATCTATGCAGA
GGAGCCGAAATTCTCAACTGTTAA -> GAGCCGAAATTCTCAACTGTTAAT
TTAACGGTGTTATCGGTCCATCTT -> TAACGGTGTTATCGGTCCATCTTC
ACGCTTAGTGGATTTAGGGCCCTA -> CGCTTAGTGGATTTAGGGCCCTAC
AAGAGCCCTAATCGGAGCCAGGTT -> AGAGCCCTAATCGGAGCCAGGTTG
ACAGACTAGACTTACGGCTTACTT -> CAGACTAGACTTACGGCTTACTTC
TCTGTAGCATGTCCGACGCTTAGT -> CTGTAGCATGTCCGACGCTTAGTG
AGCTTAACAATATCTCTTACCATT -> GCTTAACAATATCTCTTACCATTG
GGGTAGGGGACTCCGATTAATTAG -> GGTAGGGGACTCCGATTAATTAGT
AGTATTCCAAGGAGAGGGAGCTGC -> GTATTCCAAGGAGAGGGAGCTGCA
TTCACGAAACTATTAGCGTGTACG -> TCACGAAACTATTAGCGTGTACGG
AGTCGTCGAGGTGCGTACTGATTT -> GTCGTCGAGGTGCGTACTGATTTC
GTCCATCTTCCTACGAGCCGACCT -> TCCATCTTCCTACGAGCCGACCTC
CTTACTTCCGGTAACCCGGTAGTA -> TTACTTCCGGTAACCCGGTAGTAT
GCCAAACCTTCTAGTAACAGGTCC -> CCAAACCTTCTAGTAACAGGTCCT
CGGAAGGGTAGGGGACTCCGATTA -> GGAAGGGTAGGGGACTCCGATTAA
CGCTTAGTGGATTTAGGGCCCTAC -> GCTTAGTGGATTTAGGGCCCTACA
ACTTACGGCTTACTTCCGGTAACC -> CTTACGGCTTACTTCCGGTAACCC
TGGACCGGTCGACCAGTCAAGACG -> GGACCGGTCGACCAGTCAAGACGC
AATACGGCGTTTGTATATGGAATC -> ATACGGCGTTTGTATATGGAATCA
GGGCGAGCGCAATGCTCCTTCGTA -> GGCGAGCGCAATGCTCCTTCGTAA
TACCCAACGTGATTGGCCTGGGGA -> ACCCAACGTGATTGGCCTGGGGAA
TTCTAGGCTACCCAACGTGATTGG -> TCTAGGCTACCCAACGTGATTGGC
TAACAATATCTCTTACCATTGGGC -> AACAATATCTCTTACCATTGGGCT
GATGATCGACTGCGAGACAATGCG -> ATGATCGACTGCGAGACAATGCGG
GTACATGGTGTTGCCTGTAACAGA -> TACATGGTGTTGCCTGTAACAGAC
CGTATAGCAGACTCTTCAGTATAC -> GTATAGCAGACTCTTCAGTATACT
TGTACATCTCCTAGCCTAGAAGGG -> GTACATCTCCTAGCCTAGAAGGGC
AACAGACTGCAAGTATCTTACGTA -> ACAGACTGCAAGTATCTTACGTAA
CGTGTTGCCGTGGCGTGTCTTTTC -> GTGTTGCCGTGGCGTGTCTTTTCA
TGGCATGACAAAGGCGGATGTCTG -> GGCATGACAAAGGCGGATGTCTGG
GCACGGAACGACCCACGTATAGCA -> CACGGAACGACCCACGTATAGCAG
ATGGAATCAGTCGTCGAGGTGCGT -> TGGAATCAGTCGTCGAGGTGCGTA
GTAGGGGACTCCGATTAATTAGTA -> TAGGGGACTCCGATTAATTAGTAT
CTCTTCAGTATACTAAAATCCTAC -> TCTTCAGTATACTAAAATCCTACG
CCCGCCATGGGGTAACCTAAATTG -> CCGCCATGGGGTAACCTAAATTGC
CGTTTTGGCGCTCCACGGTTATCA -> GTTTTGGCGCTCCACGGTTATCAC
GTAATGACAGTTAACGGTGTTATC -> TAATGACAGTTAACGGTGTTATCG
CGGACCAGATGGTTCGTAATTATC -> GGACCAGATGGTTCGTAATTATCT
TTAGGTTTGCGCCGCGCGCGGAAG -> TAGGTTTGCGCCGCGCGCGGAAGG
CATATGGTAGCTGCTCTTTATTCC -> ATATGGTAGCTGCTCTTTATTCCG
CCGGTTTATGTACATATGGTAGCT -> CGGTTTATGTACATATGGTAGCTG
AGCTTGCCTACTGCGACATACCTT -> GCTTGCCTACTGCGACATACCTTG
GGTTGACGCGCCGTACACACTAGC -> GTTGACGCGCCGTACACACTAGCC
ACTGTGATTCAGCCCATCAGCTTA -> CTGTGATTCAGCCCATCAGCTTAG
GGTAAAAGCTAACCAGCGTTCATC -> GTAAAAGCTAACCAGCGTTCATCC
AGAGGGAGCTGCAGCACGGAATGA -> GAGGGAGCTGCAGCACGGAATGAG
CCTTCTGCTACGGAGAAAGCCCGT -> CTTCTGCTACGGAGAAAGCCCGTT
GCAGACTCTTCAGTATACTAAAAT -> CAGACTCTTCAGTATACTAAAATC
CAAGTGTCGTCGCTAAGGGGGCTG -> AAGTGTCGTCGCTAAGGGGGCTGG
TTCGGAGCCGAAATTCTCAACTGT -> TCGGAGCCGAAATTCTCAACTGTT
ACGGTAATCCTAAGGACTGTGATT -> CGGTAATCCTAAGGACTGTGATTC
ATATGCTGTCCAAGAGCCCTAATC -> TATGCTGTCCAAGAGCCCTAATCG
TTGACGCGCCGTACACACTAGCCC -> TGACGCGCCGTACACACTAGCCCT
GCTGCAGCACGGAATGAGAAATCT -> CTGCAGCACGGAATGAGAAATCTA
GAAATATGCTGTCCAAGAGCCCTA -> AAATATGCTGTCCAAGAGCCCTAA
GCGATGGTAAAAGCTAACCAGCGT -> CGATGGTAAAAGCTAACCAGCGTT
GGGGTAACCTAAATTGCATGGTCT -> GGGTAACCTAAATTGCATGGTCTG
GCCATGGGGTAACCTAAATTGCAT -> CCATGGGGTAACCTAAATTGCATG
TACCTTGGACCGGTCGACCAGTCA -> ACCTTGGACCGGTCGACCAGTCAA
GGCGATGGTAAAAGCTAACCAGCG -> GCGATGGTAAAAGCTAACCAGCGT
GAGCCGAAATTCTCAACTGTTAAT -> AGCCGAAATTCTCAACTGTTAATC
GCTCCGCGGCTTGTCTTCTTTCAG -> CTCCGCGGCTTGTCTTCTTTCAGG
AGTAGCCAAACCTTCTAGTAACAG -> GTAGCCAAACCTTCTAGTAACAGG
GGACTCCGATTAATTAGTATTCCA -> GACTCCGATTAATTAGTATTCCAA
GGTGTTATCGGTCCATCTTCCTAC -> GTGTTATCGGTCCATCTTCCTACG
TGATTGGCCTGGGGAACCCATCAT -> GATTGGCCTGGGGAACCCATCATT
TATATGGAATCAGTCGTCGAGGTG -> ATATGGAATCAGTCGTCGAGGTGC
CGGAAGTCTGTTGTGAGACGACTT -> GGAAGTCTGTTGTGAGACGACTTG
TGCTCTTTATTCCGGTATAGCACC -> GCTCTTTATTCCGGTATAGCACCT
ACTTCCGGTAACCCGGTAGTATAT -> CTTCCGGTAACCCGGTAGTATATA
AACGACCCACGTATAGCAGACTCT -> ACGACCCACGTATAGCAGACTCTT
CATACACGGTAATCCTAAGGACTG -> ATACACGGTAATCCTAAGGACTGT
AACCAGCGTTCATCCTCACAGATG -> ACCAGCGTTCATCCTCACAGATGA
CACGGACCAGATGGTTCGTAATTA -> ACGGACCAGATGGTTCGTAATTAT
TAACCCGGTAGTATATACCTTGGT -> AACCCGGTAGTATATACCTTGGTA
TGTCTTTTCAACTATTGTCACCAT -> GTCTTTTCAACTATTGTCACCATT
GTCCGACGCTTAGTGGATTTAGGG -> TCCGACGCTTAGTGGATTTAGGGC
CAGGTTGACGCGCCGTACACACTA -> AGGTTGACGCGCCGTACACACTAG
TCTTACACCATTTTTTCGCAGTAC -> CTTACACCATTTTTTCGCAGTACT
CTGATTTCACACCTTCTGCTACGG -> TGATTTCACACCTTCTGCTACGGA
CATGGTGTTGCCTGTAACAGACTG -> ATGGTGTTGCCTGTAACAGACTGC
TCACCGTCCTGAGCTTGCCTACTG -> CACCGTCCTGAGCTTGCCTACTGC
AAAGAATTCACGAAACTATTAGCG -> AAGAATTCACGAAACTATTAGCGT
AGGATAAAAACATAGACATGACCG -> GGATAAAAACATAGACATGACCGA
CGACCTCTCCCACAAGCATACACG -> GACCTCTCCCACAAGCATACACGG
ACAATGCGGTTACTCTCGCAGAGT -> CAATGCGGTTACTCTCGCAGAGTC
GGATTATGGCGATGGTAAAAGCTA -> GATTATGGCGATGGTAAAAGCTAA
GTTCACACGCGTTTTGGCGCTCCA -> TTCACACGCGTTTTGGCGCTCCAC
TATATCTGGTCCGGCCTTAGGGCT -> ATATCTGGTCCGGCCTTAGGGCTA
CGCTGGGATTATGGCGATGGTAAA -> GCTGGGATTATGGCGATGGTAAAA
ATGCCACCATGTTCACACGCGTTT -> TGCCACCATGTTCACACGCGTTTT
ATGCGGTTACTCTCGCAGAGTCAT -> TGCGGTTACTCTCGCAGAGTCATG
CACAGAATACGGCGTTTGTATATG -> ACAGAATACGGCGTTTGTATATGG
AGACTGCAAGTATCTTACGTAATG -> GACTGCAAGTATCTTACGTAATGA
TTAGCTCTGTACATGGTGTTGCCT -> TAGCTCTGTACATGGTGTTGCCTG
GTCCAAGAGCCCTAATCGGAGCCA -> TCCAAGAGCCCTAATCGGAGCCAG
CGAAATATGCTGTCCAAGAGCCCT -> GAAATATGCTGTCCAAGAGCCCTA
AGAGAACCTGAAACCGGTTTATGT -> GAGAACCTGAAACCGGTTTATGTA
TAGCCCTTGAGAAGTAGCCGTGTA -> AGCCCTTGAGAAGTAGCCGTGTAT
AAAACATAGACATGACCGAATCTG -> AAACATAGACATGACCGAATCTGT
TTGGGCTGTACATCTCCTAGCCTA -> TGGGCTGTACATCTCCTAGCCTAG
TAGATATGCATTCGCCCGAAATAT -> AGATATGCATTCGCCCGAAATATG
TATGCAGAGACAACGTGCTAGCAT -> ATGCAGAGACAACGTGCTAGCATT
CTTCCGGTAACCCGGTAGTATATA -> TTCCGGTAACCCGGTAGTATATAC
GAACTAGAGCTGTCAGCGACACGG -> AACTAGAGCTGTCAGCGACACGGA
AACTGTTAATCCGGAGTAGCCAAA -> ACTGTTAATCCGGAGTAGCCAAAC
CGGAGAAAGCCCGTTATATCCTAT -> GGAGAAAGCCCGTTATATCCTATG
CTGGGGAACCCATCATTAAAGTTA -> TGGGGAACCCATCATTAAAGTTAT
AACCTAAATTGCATGGTCTGAGGT -> ACCTAAATTGCATGGTCTGAGGTA
AGTTTAGCTCTGTACATGGTGTTG -> GTTTAGCTCTGTACATGGTGTTGC
TGGGATGGCAGCTGGCGTAGCGAT -> GGGATGGCAGCTGGCGTAGCGATG
ATAGACATGACCGAATCTGTAGCA -> TAGACATGACCGAATCTGTAGCAT
TACTAAAATCCTACGAACTAGAGC -> ACTAAAATCCTACGAACTAGAGCT
GTAAAAGCTAACCAGCGTTCATCC -> TAAAAGCTAACCAGCGTTCATCCT
GCCTTAGGGCTAGTTTAGCTCTGT -> CCTTAGGGCTAGTTTAGCTCTGTA
AACGTGTTGCCGTGGCGTGTCTTT -> ACGTGTTGCCGTGGCGTGTCTTTT
AACAGGTTAGATATGCATTCGCCC -> ACAGGTTAGATATGCATTCGCCCG
AGCCCATCAGCTTAGGTTTGCGCC -> GCCCATCAGCTTAGGTTTGCGCCG
TTATGGCGATGGTAAAAGCTAACC -> TATGGCGATGGTAAAAGCTAACCA
AAAATCCTACGAACTAGAGCTGTC -> AAATCCTACGAACTAGAGCTGTCA
CTTACGTAATGACAGTTAACGGTG -> TTACGTAATGACAGTTAACGGTGT
ATACGGCGTTTGTATATGGAATCA -> TACGGCGTTTGTATATGGAATCAG
GGCTAGTTTAGCTCTGTACATGGT -> GCTAGTTTAGCTCTGTACATGGTG
TTCTAGTAACAGGTCCTGCTCGCG -> TCTAGTAACAGGTCCTGCTCGCGA
TCCATCTTCCTACGAGCCGACCTC -> CCATCTTCCTACGAGCCGACCTCT
CCAGGTTGACGCGCCGTACACACT -> CAGGTTGACGCGCCGTACACACTA
GTCATGGACACGGGCGTTGGCATG -> TCATGGACACGGGCGTTGGCATGA
CGAATCTGTAGCATGTCCGACGCT -> GAATCTGTAGCATGTCCGACGCTT
ATCTTCCTACGAGCCGACCTCTCC -> TCTTCCTACGAGCCGACCTCTCCC
GCTTAGGTTTGCGCCGCGCGCGGA -> CTTAGGTTTGCGCCGCGCGCGGAA
GAGCCCTAATCGGAGCCAGGTTGA -> AGCCCTAATCGGAGCCAGGTTGAC
ACATGGTGTTGCCTGTAACAGACT -> CATGGTGTTGCCTGTAACAGACTG
CTAGTTTAGCTCTGTACATGGTGT -> TAGTTTAGCTCTGTACATGGTGTT
CAGTACTAGAGCTTAACAATATCT -> AGTACTAGAGCTTAACAATATCTC
TACTTCCGGTAACCCGGTAGTATA -> ACTTCCGGTAACCCGGTAGTATAT
CCGGTCGACCAGTCAAGACGCAAG -> CGGTCGACCAGTCAAGACGCAAGT
TAGTGGATTTAGGGCCCTACATTC -> AGTGGATTTAGGGCCCTACATTCT
TCAAGACGCAAGTGTCGTCGCTAA -> CAAGACGCAAGTGTCGTCGCTAAG
CGGTAATCCTAAGGACTGTGATTC -> GGTAATCCTAAGGACTGTGATTCA
AATCAGTCGTCGAGGTGCGTACTG -> ATCAGTCGTCGAGGTGCGTACTGA
TCAGGATAAAAACATAGACATGAC -> CAGGATAAAAACATAGACATGACC
GTCGTCGCTAAGGGGGCTGGTGGA -> TCGTCGCTAAGGGGGCTGGTGGAG
ACTATTAGCGTGTACGGCCTTTCT -> CTATTAGCGTGTACGGCCTTTCTC
GCAATTGGGATGGCAGCTGGCGTA -> CAATTGGGATGGCAGCTGGCGTAG
CTCCGATTAATTAGTATTCCAAGG -> TCCGATTAATTAGTATTCCAAGGA
TCAGTATACTAAAATCCTACGAAC -> CAGTATACTAAAATCCTACGAACT
CGGGATCCTCCCGCCATGGGGTAA -> GGGATCCTCCCGCCATGGGGTAAC
CGTGATTGAATGCTCCGCGGCTTG -> GTGATTGAATGCTCCGCGGCTTGT
AAGGGCGTTACACCATGCCACCAT -> AGGGCGTTACACCATGCCACCATG
ATGCCACTCCCGGGATCCTCCCGC -> TGCCACTCCCGGGATCCTCCCGCC
TCTCGGAGAGAACCTGAAACCGGT -> CTCGGAGAGAACCTGAAACCGGTT
GGGATGGCAGCTGGCGTAGCGATG -> GGATGGCAGCTGGCGTAGCGATGC
GGTTTGCGCCGCGCGCGGAAGGGT -> GTTTGCGCCGCGCGCGGAAGGGTA
GACATACCTTGGACCGGTCGACCA -> ACATACCTTGGACCGGTCGACCAG
GGCTCGGAAGTCTGTTGTGAGACG -> GCTCGGAAGTCTGTTGTGAGACGA
GCCCATCAGCTTAGGTTTGCGCCG -> CCCATCAGCTTAGGTTTGCGCCGC
CCATTTAGGCACGGAACGACCCAC -> CATTTAGGCACGGAACGACCCACG
GGGAACCCATCATTAAAGTTATGC -> GGAACCCATCATTAAAGTTATGCC
AGTAACAGGTCCTGCTCGCGAGTA -> GTAACAGGTCCTGCTCGCGAGTAA
CTGGCGTAGCGATGCCATACACCA -> TGGCGTAGCGATGCCATACACCAC
TGCTACGGAGAAAGCCCGTTATAT -> GCTACGGAGAAAGCCCGTTATATC
TCCCGCCATGGGGTAACCTAAATT -> CCCGCCATGGGGTAACCTAAATTG
CCTTTCTCGGAGAGAACCTGAAAC -> CTTTCTCGGAGAGAACCTGAAACC
TCACACCTTCTGCTACGGAGAAAG -> CACACCTTCTGCTACGGAGAAAGC
TAGTATTCCAAGGAGAGGGAGCTG -> AGTATTCCAAGGAGAGGGAGCTGC
GACGCTTAGTGGATTTAGGGCCCT -> ACGCTTAGTGGATTTAGGGCCCTA
TATCACCGTCCTGAGCTTGCCTAC -> ATCACCGTCCTGAGCTTGCCTACT
GCGCTGGGATTATGGCGATGGTAA -> CGCTGGGATTATGGCGATGGTAAA
GCACGCGCTGGGATTATGGCGATG -> CACGCGCTGGGATTATGGCGATGG
AAGCTAACCAGCGTTCATCCTCAC -> AGCTAACCAGCGTTCATCCTCACA
CGTTACACCATGCCACCATGTTCA -> GTTACACCATGCCACCATGTTCAC
GACCTCTCCCACAAGCATACACGG -> ACCTCTCCCACAAGCATACACGGT
GGGCCCTACATTCTGGATGCACGC -> GGCCCTACATTCTGGATGCACGCG
TGCAAGTATCTTACGTAATGACAG -> GCAAGTATCTTACGTAATGACAGT
AGATTGGACCGCGGCTCGGAAGTC -> GATTGGACCGCGGCTCGGAAGTCT
ATCCTAAGGACTGTGATTCAGCCC -> TCCTAAGGACTGTGATTCAGCCCA
GGTGATTAGATCCGGAGATTGGAC -> GTGATTAGATCCGGAGATTGGACC
TAGCAGACTCTTCAGTATACTAAA -> AGCAGACTCTTCAGTATACTAAAA
TATCCTATGCATGCTTTCGATTGT -> ATCCTATGCATGCTTTCGATTGTC
ACGTAGGCAATTGGGATGGCAGCT -> CGTAGGCAATTGGGATGGCAGCTG
TCCTAAGGACTGTGATTCAGCCCA -> CCTAAGGACTGTGATTCAGCCCAT
TGACAGTTAACGGTGTTATCGGTC -> GACAGTTAACGGTGTTATCGGTCC
GGGATCCTCCCGCCATGGGGTAAC -> GGATCCTCCCGCCATGGGGTAACC
CGATAACTTGTGCAGGATGATTCG -> GATAACTTGTGCAGGATGATTCGG
ACCTAAATTGCATGGTCTGAGGTA -> CCTAAATTGCATGGTCTGAGGTAA
TGGCGTAGCGATGCCATACACCAC -> GGCGTAGCGATGCCATACACCACA
TGTCTTATTTGATATATCTGGTCC -> GTCTTATTTGATATATCTGGTCCG
TCGTCGCTAAGGGGGCTGGTGGAG -> CGTCGCTAAGGGGGCTGGTGGAGA
ATGCATGCTTTCGATTGTCAAAGC -> TGCATGCTTTCGATTGTCAAAGCC
AATCCTACGAACTAGAGCTGTCAG -> ATCCTACGAACTAGAGCTGTCAGC
AGCGCAATGCTCCTTCGTAAAGAA -> GCGCAATGCTCCTTCGTAAAGAAT
CAGCTTAGGTTTGCGCCGCGCGCG -> AGCTTAGGTTTGCGCCGCGCGCGG
GGCATGACAAAGGCGGATGTCTGG -> GCATGACAAAGGCGGATGTCTGGT
TGGAATCAGTCGTCGAGGTGCGTA -> GGAATCAGTCGTCGAGGTGCGTAC
GCATGGTCTGAGGTAACTCCTACG -> CATGGTCTGAGGTAACTCCTACGT
GCGTTCATCCTCACAGATGACAGA -> CGTTCATCCTCACAGATGACAGAC
AATGCTCCTTCGTAAAGAATTCAC -> ATGCTCCTTCGTAAAGAATTCACG
GGGGCGAGCGCAATGCTCCTTCGT -> GGGCGAGCGCAATGCTCCTTCGTA
TGTCAGCGACACGGACCAGATGGT -> GTCAGCGACACGGACCAGATGGTT
TGAAACCGGTTTATGTACATATGG -> GAAACCGGTTTATGTACATATGGT
ACCTTGGACCGGTCGACCAGTCAA -> CCTTGGACCGGTCGACCAGTCAAG
AGCGTTCATCCTCACAGATGACAG -> GCGTTCATCCTCACAGATGACAGA
TGTGCAGGATGATTCGGAGCCGAA -> GTGCAGGATGATTCGGAGCCGAAA
ATTCTGGATGCACGCGCTGGGATT -> TTCTGGATGCACGCGCTGGGATTA
GATGATTCGGAGCCGAAATTCTCA -> ATGATTCGGAGCCGAAATTCTCAA
ACCGGTTTATGTACATATGGTAGC -> CCGGTTTATGTACATATGGTAGCT
AACGTGATTGGCCTGGGGAACCCA -> ACGTGATTGGCCTGGGGAACCCAT
GTGTTATCGGTCCATCTTCCTACG -> TGTTATCGGTCCATCTTCCTACGA
AACAATATCTCTTACCATTGGGCT -> ACAATATCTCTTACCATTGGGCTG
ATTGCATGGTCTGAGGTAACTCCT -> TTGCATGGTCTGAGGTAACTCCTA
ATTTCACACCTTCTGCTACGGAGA -> TTTCACACCTTCTGCTACGGAGAA
ACGTGATTGGCCTGGGGAACCCAT -> CGTGATTGGCCTGGGGAACCCATC
TATTCCGGTATAGCACCTGTCTTA -> ATTCCGGTATAGCACCTGTCTTAT
GCATGTCCGACGCTTAGTGGATTT -> CATGTCCGACGCTTAGTGGATTTA
CCATTGGGCTGTACATCTCCTAGC -> CATTGGGCTGTACATCTCCTAGCC
TAATGACAGTTAACGGTGTTATCG -> AATGACAGTTAACGGTGTTATCGG
GTGATTCAGCCCATCAGCTTAGGT -> TGATTCAGCCCATCAGCTTAGGTT
GACCAGATGGTTCGTAATTATCTT -> ACCAGATGGTTCGTAATTATCTTA
GAGATCTCGGGGCGAGCGCAATGC -> AGATCTCGGGGCGAGCGCAATGCT
TATATACCTTGGTAAGTCGATAAC -> ATATACCTTGGTAAGTCGATAACT
TCTGGTGATTAGATCCGGAGATTG -> CTGGTGATTAGATCCGGAGATTGG
TTTAGGCACGGAACGACCCACGTA -> TTAGGCACGGAACGACCCACGTAT
CGAGACAATGCGGTTACTCTCGCA -> GAGACAATGCGGTTACTCTCGCAG
TACTAGAGCTTAACAATATCTCTT -> ACTAGAGCTTAACAATATCTCTTA
CCACAGAATACGGCGTTTGTATAT -> CACAGAATACGGCGTTTGTATATG
CGAGTAAGACTAGATGATCGACTG -> GAGTAAGACTAGATGATCGACTGC
AAACTATTAGCGTGTACGGCCTTT -> AACTATTAGCGTGTACGGCCTTTC
TAATCGGAGCCAGGTTGACGCGCC -> AATCGGAGCCAGGTTGACGCGCCG
CACCATGTTCACACGCGTTTTGGC -> ACCATGTTCACACGCGTTTTGGCG
TCCCGGGATCCTCCCGCCATGGGG -> CCCGGGATCCTCCCGCCATGGGGT
GAGAGAACCTGAAACCGGTTTATG -> AGAGAACCTGAAACCGGTTTATGT
GTCCTGAGCTTGCCTACTGCGACA -> TCCTGAGCTTGCCTACTGCGACAT
AGTACTAGAGCTTAACAATATCTC -> GTACTAGAGCTTAACAATATCTCT
ATCATTAAAGTTATGCCACTCCCG -> TCATTAAAGTTATGCCACTCCCGG
GGTAACCCGGTAGTATATACCTTG -> GTAACCCGGTAGTATATACCTTGG
AACCCGGTAGTATATACCTTGGTA -> ACCCGGTAGTATATACCTTGGTAA
ATGACAGACTAGACTTACGGCTTA -> TGACAGACTAGACTTACGGCTTAC
GCTCGCGAGTAAGACTAGATGATC -> CTCGCGAGTAAGACTAGATGATCG
CATTCTGGATGCACGCGCTGGGAT -> ATTCTGGATGCACGCGCTGGGATT
GCCTGTAACAGACTGCAAGTATCT -> CCTGTAACAGACTGCAAGTATCTT
GGGTAACCTAAATTGCATGGTCTG -> GGTAACCTAAATTGCATGGTCTGA
TATGGTAGCTGCTCTTTATTCCGG -> ATGGTAGCTGCTCTTTATTCCGGT
ACAGTTAACGGTGTTATCGGTCCA -> CAGTTAACGGTGTTATCGGTCCAT
CAAGACGCAAGTGTCGTCGCTAAG -> AAGACGCAAGTGTCGTCGCTAAGG
TCTATGCAGAGACAACGTGCTAGC -> CTATGCAGAGACAACGTGCTAGCA
GGATGATTCGGAGCCGAAATTCTC -> GATGATTCGGAGCCGAAATTCTCA
GGAGACCGCTGGGTCGTCCGCACG -> GAGACCGCTGGGTCGTCCGCACGT
CATTGGGCTGTACATCTCCTAGCC -> ATTGGGCTGTACATCTCCTAGCCT
TAAAGTTATGCCACTCCCGGGATC -> AAAGTTATGCCACTCCCGGGATCC
AGGTTTGCGCCGCGCGCGGAAGGG -> GGTTTGCGCCGCGCGCGGAAGGGT
ATGCTCCGCGGCTTGTCTTCTTTC -> TGCTCCGCGGCTTGTCTTCTTTCA
ATGTCCGACGCTTAGTGGATTTAG -> TGTCCGACGCTTAGTGGATTTAGG
TTACACCATGCCACCATGTTCACA -> TACACCATGCCACCATGTTCACAC
CTAGGCTACCCAACGTGATTGGCC -> TAGGCTACCCAACGTGATTGGCCT
TATGGCGATGGTAAAAGCTAACCA -> ATGGCGATGGTAAAAGCTAACCAG
GGTAAGTCGATAACTTGTGCAGGA -> GTAAGTCGATAACTTGTGCAGGAT
GACGACTTGACCTTGAGATCTCGG -> ACGACTTGACCTTGAGATCTCGGG
ACATGACCGAATCTGTAGCATGTC -> CATGACCGAATCTGTAGCATGTCC
GTATACTAAAATCCTACGAACTAG -> TATACTAAAATCCTACGAACTAGA
AATTCACGAAACTATTAGCGTGTA -> ATTCACGAAACTATTAGCGTGTAC
TTCGCAGTACTAGAGCTTAACAAT -> TCGCAGTACTAGAGCTTAACAATA
ATACTAAAATCCTACGAACTAGAG -> TACTAAAATCCTACGAACTAGAGC
TGTACGGCCTTTCTCGGAGAGAAC -> GTACGGCCTTTCTCGGAGAGAACC
AAGCCCGTTATATCCTATGCATGC -> AGCCCGTTATATCCTATGCATGCT
CCTTGGTAAGTCGATAACTTGTGC -> CTTGGTAAGTCGATAACTTGTGCA
ATGCATTCGCCCGAAATATGCTGT -> TGCATTCGCCCGAAATATGCTGTC
TTATATCCTATGCATGCTTTCGAT -> TATATCCTATGCATGCTTTCGATT
GACAGACTAGACTTACGGCTTACT -> ACAGACTAGACTTACGGCTTACTT
AGGGCTAGTTTAGCTCTGTACATG -> GGGCTAGTTTAGCTCTGTACATGG
TAGGTTTGCGCCGCGCGCGGAAGG -> AGGTTTGCGCCGCGCGCGGAAGGG
TATACTAAAATCCTACGAACTAGA -> ATACTAAAATCCTACGAACTAGAG
CTGCTCTTTATTCCGGTATAGCAC -> TGCTCTTTATTCCGGTATAGCACC
CACGGAACGACCCACGTATAGCAG -> ACGGAACGACCCACGTATAGCAGA
CTAAGGACTGTGATTCAGCCCATC -> TAAGGACTGTGATTCAGCCCATCA
GAGAAAGCCCGTTATATCCTATGC -> AGAAAGCCCGTTATATCCTATGCA
TTGCCTGTAACAGACTGCAAGTAT -> TGCCTGTAACAGACTGCAAGTATC
GACTGCAAGTATCTTACGTAATGA -> ACTGCAAGTATCTTACGTAATGAC
GGGGCTGGTGGAGACCGCTGGGTC -> GGGCTGGTGGAGACCGCTGGGTCG
ATGACAGTTAACGGTGTTATCGGT -> TGACAGTTAACGGTGTTATCGGTC
CACGTGATTGAATGCTCCGCGGCT -> ACGTGATTGAATGCTCCGCGGCTT
CCAAGGAGAGGGAGCTGCAGCACG -> CAAGGAGAGGGAGCTGCAGCACGG
GACTTGACCTTGAGATCTCGGGGC -> ACTTGACCTTGAGATCTCGGGGCG
TAGTATATACCTTGGTAAGTCGAT -> AGTATATACCTTGGTAAGTCGATA
CTCTTTATTCCGGTATAGCACCTG -> TCTTTATTCCGGTATAGCACCTGT
TATTTGATATATCTGGTCCGGCCT -> ATTTGATATATCTGGTCCGGCCTT
CCTGCTCGCGAGTAAGACTAGATG -> CTGCTCGCGAGTAAGACTAGATGA
ATAAAAACATAGACATGACCGAAT -> TAAAAACATAGACATGACCGAATC
TGTCTTCTTTCAGGATAAAAACAT -> GTCTTCTTTCAGGATAAAAACATA
CAGAGTCATGGACACGGGCGTTGG -> AGAGTCATGGACACGGGCGTTGGC
CTGGATGCACGCGCTGGGATTATG -> TGGATGCACGCGCTGGGATTATGG
AGTATCTTACGTAATGACAGTTAA -> GTATCTTACGTAATGACAGTTAAC
CATACCTTGGACCGGTCGACCAGT -> ATACCTTGGACCGGTCGACCAGTC
TGGGCTGTACATCTCCTAGCCTAG -> GGGCTGTACATCTCCTAGCCTAGA
TTGGACCGGTCGACCAGTCAAGAC -> TGGACCGGTCGACCAGTCAAGACG
CTCCGCGGCTTGTCTTCTTTCAGG -> TCCGCGGCTTGTCTTCTTTCAGGA
CGCGAGTAAGACTAGATGATCGAC -> GCGAGTAAGACTAGATGATCGACT
CGTAGCGATGCCATACACCACAGA -> GTAGCGATGCCATACACCACAGAA
CCTACTGCGACATACCTTGGACCG -> CTACTGCGACATACCTTGGACCGG
TAACCTAAATTGCATGGTCTGAGG -> AACCTAAATTGCATGGTCTGAGGT
GGTAGTATATACCTTGGTAAGTCG -> GTAGTATATACCTTGGTAAGTCGA
GTTGCCGTGGCGTGTCTTTTCAAC -> TTGCCGTGGCGTGTCTTTTCAACT
AACATAGACATGACCGAATCTGTA -> ACATAGACATGACCGAATCTGTAG
TACTGATTTCACACCTTCTGCTAC -> ACTGATTTCACACCTTCTGCTACG
ACAACGTGCTAGCATTCTAGGCTA -> CAACGTGCTAGCATTCTAGGCTAC
ACCCAACGTGATTGGCCTGGGGAA -> CCCAACGTGATTGGCCTGGGGAAC
GCGACACGGACCAGATGGTTCGTA -> CGACACGGACCAGATGGTTCGTAA
CACCACAGAATACGGCGTTTGTAT -> ACCACAGAATACGGCGTTTGTATA
GATCCTCCCGCCATGGGGTAACCT -> ATCCTCCCGCCATGGGGTAACCTA
CCTACGTAGGCAATTGGGATGGCA -> CTACGTAGGCAATTGGGATGGCAG
AAGACGCAAGTGTCGTCGCTAAGG -> AGACGCAAGTGTCGTCGCTAAGGG
GTTAACGGTGTTATCGGTCCATCT -> TTAACGGTGTTATCGGTCCATCTT
AGGTGCGTACTGATTTCACACCTT -> GGTGCGTACTGATTTCACACCTTC
AACCTTCTAGTAACAGGTCCTGCT -> ACCTTCTAGTAACAGGTCCTGCTC
GGCCTTAGGGCTAGTTTAGCTCTG -> GCCTTAGGGCTAGTTTAGCTCTGT
CGGATGTCTGGTGATTAGATCCGG -> GGATGTCTGGTGATTAGATCCGGA
CATACACCACAGAATACGGCGTTT -> ATACACCACAGAATACGGCGTTTG
GCTGGGATTATGGCGATGGTAAAA -> CTGGGATTATGGCGATGGTAAAAG
AGACTTACGGCTTACTTCCGGTAA -> GACTTACGGCTTACTTCCGGTAAC
TCCAAGGAGAGGGAGCTGCAGCAC -> CCAAGGAGAGGGAGCTGCAGCACG
ACAAAGGCGGATGTCTGGTGATTA -> CAAAGGCGGATGTCTGGTGATTAG
CCTACGAACTAGAGCTGTCAGCGA -> CTACGAACTAGAGCTGTCAGCGAC
ACACGGGCGTTGGCATGACAAAGG -> CACGGGCGTTGGCATGACAAAGGC
GCCTAGAAGGGCGTTACACCATGC -> CCTAGAAGGGCGTTACACCATGCC
AGGACTGTGATTCAGCCCATCAGC -> GGACTGTGATTCAGCCCATCAGCT
TCAGTCGTCGAGGTGCGTACTGAT -> CAGTCGTCGAGGTGCGTACTGATT
GAATGAGAAATCTATGCAGAGACA -> AATGAGAAATCTATGCAGAGACAA
CGCACGTGATTGAATGCTCCGCGG -> GCACGTGATTGAATGCTCCGCGGC
GACACGGGCGTTGGCATGACAAAG -> ACACGGGCGTTGGCATGACAAAGG
GCTCCTTCGTAAAGAATTCACGAA -> CTCCTTCGTAAAGAATTCACGAAA
GGTCCTGCTCGCGAGTAAGACTAG -> GTCCTGCTCGCGAGTAAGACTAGA
TGATTAGATCCGGAGATTGGACCG -> GATTAGATCCGGAGATTGGACCGC
TGCTCCGCGGCTTGTCTTCTTTCA -> GCTCCGCGGCTTGTCTTCTTTCAG
TAACCAGCGTTCATCCTCACAGAT -> AACCAGCGTTCATCCTCACAGATG
GATTGGCCTGGGGAACCCATCATT -> ATTGGCCTGGGGAACCCATCATTA
GTGGATTTAGGGCCCTACATTCTG -> TGGATTTAGGGCCCTACATTCTGG
ATATCCTATGCATGCTTTCGATTG -> TATCCTATGCATGCTTTCGATTGT
CCGCCATGGGGTAACCTAAATTGC -> CGCCATGGGGTAACCTAAATTGCA
TGACCGAATCTGTAGCATGTCCGA -> GACCGAATCTGTAGCATGTCCGAC
GATTCAGCCCATCAGCTTAGGTTT -> ATTCAGCCCATCAGCTTAGGTTTG
ACCAGCGTTCATCCTCACAGATGA -> CCAGCGTTCATCCTCACAGATGAC
TTATGTACATATGGTAGCTGCTCT -> TATGTACATATGGTAGCTGCTCTT
CTGTAACAGACTGCAAGTATCTTA -> TGTAACAGACTGCAAGTATCTTAC
ATAGCACCTGTCTTATTTGATATA -> TAGCACCTGTCTTATTTGATATAT
TAACTCCTACGTAGGCAATTGGGA -> AACTCCTACGTAGGCAATTGGGAT
GACGCGCCGTACACACTAGCCCTT -> ACGCGCCGTACACACTAGCCCTTG
CCATGTTCACACGCGTTTTGGCGC -> CATGTTCACACGCGTTTTGGCGCT
GACCGGTCGACCAGTCAAGACGCA -> ACCGGTCGACCAGTCAAGACGCAA
CAAAGGCGGATGTCTGGTGATTAG -> AAAGGCGGATGTCTGGTGATTAGA
CCACGTATAGCAGACTCTTCAGTA -> CACGTATAGCAGACTCTTCAGTAT
TCTTCAGTATACTAAAATCCTACG -> CTTCAGTATACTAAAATCCTACGA
CGTGTCTTTTCAACTATTGTCACC -> GTGTCTTTTCAACTATTGTCACCA
CTGTTGTGAGACGACTTGACCTTG -> TGTTGTGAGACGACTTGACCTTGA
ACTTGACCTTGAGATCTCGGGGCG -> CTTGACCTTGAGATCTCGGGGCGA
ATCTGTAGCATGTCCGACGCTTAG -> TCTGTAGCATGTCCGACGCTTAGT
GAGAAATCTATGCAGAGACAACGT -> AGAAATCTATGCAGAGACAACGTG
TGGTTCGTAATTATCTTACACCAT -> GGTTCGTAATTATCTTACACCATT
GACCAGTCAAGACGCAAGTGTCGT -> ACCAGTCAAGACGCAAGTGTCGTC
GCCGAAATTCTCAACTGTTAATCC -> CCGAAATTCTCAACTGTTAATCCG
GCGCCGTACACACTAGCCCTTGAG -> CGCCGTACACACTAGCCCTTGAGA
TTCATCCTCACAGATGACAGACTA -> TCATCCTCACAGATGACAGACTAG
GCCCTACATTCTGGATGCACGCGC -> CCCTACATTCTGGATGCACGCGCT
GCCACCATGTTCACACGCGTTTTG -> CCACCATGTTCACACGCGTTTTGG
TGCATTCGCCCGAAATATGCTGTC -> GCATTCGCCCGAAATATGCTGTCC
GAGAGGGAGCTGCAGCACGGAATG -> AGAGGGAGCTGCAGCACGGAATGA
ACATAGACATGACCGAATCTGTAG -> CATAGACATGACCGAATCTGTAGC
ACATACCTTGGACCGGTCGACCAG -> CATACCTTGGACCGGTCGACCAGT
GAATACGGCGTTTGTATATGGAAT -> AATACGGCGTTTGTATATGGAATC
TTTCACACCTTCTGCTACGGAGAA -> TTCACACCTTCTGCTACGGAGAAA
CACGGAATGAGAAATCTATGCAGA -> ACGGAATGAGAAATCTATGCAGAG
CATCCTCACAGATGACAGACTAGA -> ATCCTCACAGATGACAGACTAGAC
TGGGATTATGGCGATGGTAAAAGC -> GGGATTATGGCGATGGTAAAAGCT
CGCCGTACACACTAGCCCTTGAGA -> GCCGTACACACTAGCCCTTGAGAA
CGTGATTGGCCTGGGGAACCCATC -> GTGATTGGCCTGGGGAACCCATCA
GAAGGGCGTTACACCATGCCACCA -> AAGGGCGTTACACCATGCCACCAT
ACACTAGCCCTTGAGAAGTAGCCG -> CACTAGCCCTTGAGAAGTAGCCGT
TAGCATTCTAGGCTACCCAACGTG -> AGCATTCTAGGCTACCCAACGTGA
TTATTCCGGTATAGCACCTGTCTT -> TATTCCGGTATAGCACCTGTCTTA
AGCCTAGAAGGGCGTTACACCATG -> GCCTAGAAGGGCGTTACACCATGC
ACTAGAGCTTAACAATATCTCTTA -> CTAGAGCTTAACAATATCTCTTAC
TGCGACATACCTTGGACCGGTCGA -> GCGACATACCTTGGACCGGTCGAC
GGCGTTACACCATGCCACCATGTT -> GCGTTACACCATGCCACCATGTTC
AGACTAGATGATCGACTGCGAGAC -> GACTAGATGATCGACTGCGAGACA
TGAGAAGTAGCCGTGTATCGTCAA -> GAGAAGTAGCCGTGTATCGTCAAC
ATTTAGGCACGGAACGACCCACGT -> TTTAGGCACGGAACGACCCACGTA
TCCGGTAACCCGGTAGTATATACC -> CCGGTAACCCGGTAGTATATACCT
TGCCATACACCACAGAATACGGCG -> GCCATACACCACAGAATACGGCGT
GCGTTTGTATATGGAATCAGTCGT -> CGTTTGTATATGGAATCAGTCGTC
ACTATTGTCACCATTTAGGCACGG -> CTATTGTCACCATTTAGGCACGGA
GTAACAGACTGCAAGTATCTTACG -> TAACAGACTGCAAGTATCTTACGT
GCAGAGACAACGTGCTAGCATTCT -> CAGAGACAACGTGCTAGCATTCTA
AGGGGGCTGGTGGAGACCGCTGGG -> GGGGGCTGGTGGAGACCGCTGGGT
TGTGAGACGACTTGACCTTGAGAT -> GTGAGACGACTTGACCTTGAGATC
TCCTTCGTAAAGAATTCACGAAAC -> CCTTCGTAAAGAATTCACGAAACT
TAACTTGTGCAGGATGATTCGGAG -> AACTTGTGCAGGATGATTCGGAGC
GGGATTATGGCGATGGTAAAAGCT -> GGATTATGGCGATGGTAAAAGCTA
CTTGCCTACTGCGACATACCTTGG -> TTGCCTACTGCGACATACCTTGGA
AGCCGAAATTCTCAACTGTTAATC -> GCCGAAATTCTCAACTGTTAATCC
TTGCCGTGGCGTGTCTTTTCAACT -> TGCCGTGGCGTGTCTTTTCAACTA
CTCTCGCAGAGTCATGGACACGGG -> TCTCGCAGAGTCATGGACACGGGC
GAGGTGCGTACTGATTTCACACCT -> AGGTGCGTACTGATTTCACACCTT
TGATCGACTGCGAGACAATGCGGT -> GATCGACTGCGAGACAATGCGGTT
CAAGCATACACGGTAATCCTAAGG -> AAGCATACACGGTAATCCTAAGGA
TTTTCGCAGTACTAGAGCTTAACA -> TTTCGCAGTACTAGAGCTTAACAA
TACACCATTTTTTCGCAGTACTAG -> ACACCATTTTTTCGCAGTACTAGA
GTAATTATCTTACACCATTTTTTC -> TAATTATCTTACACCATTTTTTCG
GTCGAGGTGCGTACTGATTTCACA -> TCGAGGTGCGTACTGATTTCACAC
CGATGGTAAAAGCTAACCAGCGTT -> GATGGTAAAAGCTAACCAGCGTTC
TATAGCAGACTCTTCAGTATACTA -> ATAGCAGACTCTTCAGTATACTAA
GCTCTGTACATGGTGTTGCCTGTA -> CTCTGTACATGGTGTTGCCTGTAA
GCGTACTGATTTCACACCTTCTGC -> CGTACTGATTTCACACCTTCTGCT
CCCTAATCGGAGCCAGGTTGACGC -> CCTAATCGGAGCCAGGTTGACGCG
TGTTGCCGTGGCGTGTCTTTTCAA -> GTTGCCGTGGCGTGTCTTTTCAAC
TCCACGGTTATCACCGTCCTGAGC -> CCACGGTTATCACCGTCCTGAGCT
AGAGCTGTCAGCGACACGGACCAG -> GAGCTGTCAGCGACACGGACCAGA
GTATATACCTTGGTAAGTCGATAA -> TATATACCTTGGTAAGTCGATAAC
CCAAACCTTCTAGTAACAGGTCCT -> CAAACCTTCTAGTAACAGGTCCTG
CGCGGCTTGTCTTCTTTCAGGATA -> GCGGCTTGTCTTCTTTCAGGATAA
GGAACGACCCACGTATAGCAGACT -> GAACGACCCACGTATAGCAGACTC
CCTCCCGCCATGGGGTAACCTAAA -> CTCCCGCCATGGGGTAACCTAAAT
ATCAGTCGTCGAGGTGCGTACTGA -> TCAGTCGTCGAGGTGCGTACTGAT
GTACATATGGTAGCTGCTCTTTAT -> TACATATGGTAGCTGCTCTTTATT
TTTTCAACTATTGTCACCATTTAG -> TTTCAACTATTGTCACCATTTAGG
TCAGCCCATCAGCTTAGGTTTGCG -> CAGCCCATCAGCTTAGGTTTGCGC
GCTCCACGGTTATCACCGTCCTGA -> CTCCACGGTTATCACCGTCCTGAG
TAATTATCTTACACCATTTTTTCG -> AATTATCTTACACCATTTTTTCGC
CAACTATTGTCACCATTTAGGCAC -> AACTATTGTCACCATTTAGGCACG
TCTTTATTCCGGTATAGCACCTGT -> CTTTATTCCGGTATAGCACCTGTC
GTTTTGGCGCTCCACGGTTATCAC -> TTTTGGCGCTCCACGGTTATCACC
GTTATCGGTCCATCTTCCTACGAG -> TTATCGGTCCATCTTCCTACGAGC
GATGGTAAAAGCTAACCAGCGTTC -> ATGGTAAAAGCTAACCAGCGTTCA
AAGAATTCACGAAACTATTAGCGT -> AGAATTCACGAAACTATTAGCGTG
ACACGGACCAGATGGTTCGTAATT -> CACGGACCAGATGGTTCGTAATTA
GGTGCGTACTGATTTCACACCTTC -> GTGCGTACTGATTTCACACCTTCT
ATGGTTCGTAATTATCTTACACCA -> TGGTTCGTAATTATCTTACACCAT
ATATCTCTTACCATTGGGCTGTAC -> TATCTCTTACCATTGGGCTGTACA
TATGTACATATGGTAGCTGCTCTT -> ATGTACATATGGTAGCTGCTCTTT
CGAAATTCTCAACTGTTAATCCGG -> GAAATTCTCAACTGTTAATCCGGA
GTGATTGAATGCTCCGCGGCTTGT -> TGATTGAATGCTCCGCGGCTTGTC
GACTAGATGATCGACTGCGAGACA -> ACTAGATGATCGACTGCGAGACAA
GTGATTAGATCCGGAGATTGGACC -> TGATTAGATCCGGAGATTGGACCG
AACCGGTTTATGTACATATGGTAG -> ACCGGTTTATGTACATATGGTAGC
GGAGAAAGCCCGTTATATCCTATG -> GAGAAAGCCCGTTATATCCTATGC
ACACCATTTTTTCGCAGTACTAGA -> CACCATTTTTTCGCAGTACTAGAG
AAATCTATGCAGAGACAACGTGCT -> AATCTATGCAGAGACAACGTGCTA
GGTAACTCCTACGTAGGCAATTGG -> GTAACTCCTACGTAGGCAATTGGG
TAGCTGCTCTTTATTCCGGTATAG -> AGCTGCTCTTTATTCCGGTATAGC
CGTAATGACAGTTAACGGTGTTAT -> GTAATGACAGTTAACGGTGTTATC
TGAGGTAACTCCTACGTAGGCAAT -> GAGGTAACTCCTACGTAGGCAATT
TTGCATGGTCTGAGGTAACTCCTA -> TGCATGGTCTGAGGTAACTCCTAC
GGCCTGGGGAACCCATCATTAAAG -> GCCTGGGGAACCCATCATTAAAGT
CTTAACAATATCTCTTACCATTGG -> TTAACAATATCTCTTACCATTGGG
TGGCGCTCCACGGTTATCACCGTC -> GGCGCTCCACGGTTATCACCGTCC
GGCTTACTTCCGGTAACCCGGTAG -> GCTTACTTCCGGTAACCCGGTAGT
CGAGGTGCGTACTGATTTCACACC -> GAGGTGCGTACTGATTTCACACCT
TAACAGACTGCAAGTATCTTACGT -> AACAGACTGCAAGTATCTTACGTA
ATCCTCCCGCCATGGGGTAACCTA -> TCCTCCCGCCATGGGGTAACCTAA
GATCGACTGCGAGACAATGCGGTT -> ATCGACTGCGAGACAATGCGGTTA
TACTGCGACATACCTTGGACCGGT -> ACTGCGACATACCTTGGACCGGTC
TAGGGCCCTACATTCTGGATGCAC -> AGGGCCCTACATTCTGGATGCACG
AGATATGCATTCGCCCGAAATATG -> GATATGCATTCGCCCGAAATATGC
CAGACTGCAAGTATCTTACGTAAT -> AGACTGCAAGTATCTTACGTAATG
ATTCTCAACTGTTAATCCGGAGTA -> TTCTCAACTGTTAATCCGGAGTAG
TATGCATTCGCCCGAAATATGCTG -> ATGCATTCGCCCGAAATATGCTGT
TTCTCAACTGTTAATCCGGAGTAG -> TCTCAACTGTTAATCCGGAGTAGC
AGCGATGCCATACACCACAGAATA -> GCGATGCCATACACCACAGAATAC
GCCGACCTCTCCCACAAGCATACA -> CCGACCTCTCCCACAAGCATACAC
AGTGTCGTCGCTAAGGGGGCTGGT -> GTGTCGTCGCTAAGGGGGCTGGTG
TCATTAAAGTTATGCCACTCCCGG -> CATTAAAGTTATGCCACTCCCGGG
TCTTTTCAACTATTGTCACCATTT -> CTTTTCAACTATTGTCACCATTTA
ACGACCCACGTATAGCAGACTCTT -> CGACCCACGTATAGCAGACTCTTC
ATGTCTGGTGATTAGATCCGGAGA -> TGTCTGGTGATTAGATCCGGAGAT
TGCGGTTACTCTCGCAGAGTCATG -> GCGGTTACTCTCGCAGAGTCATGG
AGTGGATTTAGGGCCCTACATTCT -> GTGGATTTAGGGCCCTACATTCTG
CACAGATGACAGACTAGACTTACG -> ACAGATGACAGACTAGACTTACGG
CTTTATTCCGGTATAGCACCTGTC -> TTTATTCCGGTATAGCACCTGTCT
ATTAGATCCGGAGATTGGACCGCG -> TTAGATCCGGAGATTGGACCGCGG
AGGCTACCCAACGTGATTGGCCTG -> GGCTACCCAACGTGATTGGCCTGG
AATTCTCAACTGTTAATCCGGAGT -> ATTCTCAACTGTTAATCCGGAGTA
CTATTAGCGTGTACGGCCTTTCTC -> TATTAGCGTGTACGGCCTTTCTCG
TAGATCCGGAGATTGGACCGCGGC -> AGATCCGGAGATTGGACCGCGGCT
CGTCCGCACGTGATTGAATGCTCC -> GTCCGCACGTGATTGAATGCTCCG
GCCAGGTTGACGCGCCGTACACAC -> CCAGGTTGACGCGCCGTACACACT
TGCTCGCGAGTAAGACTAGATGAT -> GCTCGCGAGTAAGACTAGATGATC
GCTGTCAGCGACACGGACCAGATG -> CTGTCAGCGACACGGACCAGATGG
GCGGAAGGGTAGGGGACTCCGATT -> CGGAAGGGTAGGGGACTCCGATTA
TCGGAGCCAGGTTGACGCGCCGTA -> CGGAGCCAGGTTGACGCGCCGTAC
ACCCATCATTAAAGTTATGCCACT -> CCCATCATTAAAGTTATGCCACTC
ACGAAACTATTAGCGTGTACGGCC -> CGAAACTATTAGCGTGTACGGCCT
ATCCTATGCATGCTTTCGATTGTC -> TCCTATGCATGCTTTCGATTGTCA
TGTCTGGTGATTAGATCCGGAGAT -> GTCTGGTGATTAGATCCGGAGATT
TCGCCCGAAATATGCTGTCCAAGA -> CGCCCGAAATATGCTGTCCAAGAG
CAACAGGTTAGATATGCATTCGCC -> AACAGGTTAGATATGCATTCGCCC
AAGGGTAGGGGACTCCGATTAATT -> AGGGTAGGGGACTCCGATTAATTA
TCTTCTTTCAGGATAAAAACATAG -> CTTCTTTCAGGATAAAAACATAGA
TGGATTTAGGGCCCTACATTCTGG -> GGATTTAGGGCCCTACATTCTGGA
CGGCCTTTCTCGGAGAGAACCTGA -> GGCCTTTCTCGGAGAGAACCTGAA
AGAAATCTATGCAGAGACAACGTG -> GAAATCTATGCAGAGACAACGTGC
CCGGAGTAGCCAAACCTTCTAGTA -> CGGAGTAGCCAAACCTTCTAGTAA
AGCTAACCAGCGTTCATCCTCACA -> GCTAACCAGCGTTCATCCTCACAG
CTACATTCTGGATGCACGCGCTGG -> TACATTCTGGATGCACGCGCTGGG
AAACATAGACATGACCGAATCTGT -> AACATAGACATGACCGAATCTGTA
CAGATGGTTCGTAATTATCTTACA -> AGATGGTTCGTAATTATCTTACAC
GCTTGTCTTCTTTCAGGATAAAAA -> CTTGTCTTCTTTCAGGATAAAAAC
TTTCAGGATAAAAACATAGACATG -> TTCAGGATAAAAACATAGACATGA
TGGGGTAACCTAAATTGCATGGTC -> GGGGTAACCTAAATTGCATGGTCT
TGGTCTGAGGTAACTCCTACGTAG -> GGTCTGAGGTAACTCCTACGTAGG
CCTGTCTTATTTGATATATCTGGT -> CTGTCTTATTTGATATATCTGGTC
ACTAAAATCCTACGAACTAGAGCT -> CTAAAATCCTACGAACTAGAGCTG
CTAAGGGGGCTGGTGGAGACCGCT -> TAAGGGGGCTGGTGGAGACCGCTG
CATTTTTTCGCAGTACTAGAGCTT -> ATTTTTTCGCAGTACTAGAGCTTA
TCCGGAGTAGCCAAACCTTCTAGT -> CCGGAGTAGCCAAACCTTCTAGTA
CTGAAACCGGTTTATGTACATATG -> TGAAACCGGTTTATGTACATATGG
AGCTGCAGCACGGAATGAGAAATC -> GCTGCAGCACGGAATGAGAAATCT
ATATGGAATCAGTCGTCGAGGTGC -> TATGGAATCAGTCGTCGAGGTGCG
GGAGAGGGAGCTGCAGCACGGAAT -> GAGAGGGAGCTGCAGCACGGAATG
GTAGTATATACCTTGGTAAGTCGA -> TAGTATATACCTTGGTAAGTCGAT
CGTGGCGTGTCTTTTCAACTATTG -> GTGGCGTGTCTTTTCAACTATTGT
GCTACCCAACGTGATTGGCCTGGG -> CTACCCAACGTGATTGGCCTGGGG
GCAGAGTCATGGACACGGGCGTTG -> CAGAGTCATGGACACGGGCGTTGG
TCCGGCCTTAGGGCTAGTTTAGCT -> CCGGCCTTAGGGCTAGTTTAGCTC
ATCTGGTCCGGCCTTAGGGCTAGT -> TCTGGTCCGGCCTTAGGGCTAGTT
TTATCTTACACCATTTTTTCGCAG -> TATCTTACACCATTTTTTCGCAGT
CTATTGTCACCATTTAGGCACGGA -> TATTGTCACCATTTAGGCACGGAA
GTACTGATTTCACACCTTCTGCTA -> TACTGATTTCACACCTTCTGCTAC
AAAAGCTAACCAGCGTTCATCCTC -> AAAGCTAACCAGCGTTCATCCTCA
ACGGTGTTATCGGTCCATCTTCCT -> CGGTGTTATCGGTCCATCTTCCTA
CAGCACGGAATGAGAAATCTATGC -> AGCACGGAATGAGAAATCTATGCA
AGGGAGCTGCAGCACGGAATGAGA -> GGGAGCTGCAGCACGGAATGAGAA
CCGTACACACTAGCCCTTGAGAAG -> CGTACACACTAGCCCTTGAGAAGT
TGCAGGATGATTCGGAGCCGAAAT -> GCAGGATGATTCGGAGCCGAAATT
GATTCGGAGCCGAAATTCTCAACT -> ATTCGGAGCCGAAATTCTCAACTG
ATGGCGATGGTAAAAGCTAACCAG -> TGGCGATGGTAAAAGCTAACCAGC
TCTCGGGGCGAGCGCAATGCTCCT -> CTCGGGGCGAGCGCAATGCTCCTT
CAAGGAGAGGGAGCTGCAGCACGG -> AAGGAGAGGGAGCTGCAGCACGGA
CCCACAAGCATACACGGTAATCCT -> CCACAAGCATACACGGTAATCCTA
GCATGACAAAGGCGGATGTCTGGT -> CATGACAAAGGCGGATGTCTGGTG
ACCTTCTGCTACGGAGAAAGCCCG -> CCTTCTGCTACGGAGAAAGCCCGT
CTAATCGGAGCCAGGTTGACGCGC -> TAATCGGAGCCAGGTTGACGCGCC
AACCCATCATTAAAGTTATGCCAC -> ACCCATCATTAAAGTTATGCCACT
GCTGGCGTAGCGATGCCATACACC -> CTGGCGTAGCGATGCCATACACCA
GTCACCATTTAGGCACGGAACGAC -> TCACCATTTAGGCACGGAACGACC
GAATCTGTAGCATGTCCGACGCTT -> AATCTGTAGCATGTCCGACGCTTA
TGCATGGTCTGAGGTAACTCCTAC -> GCATGGTCTGAGGTAACTCCTACG
CAGCGACACGGACCAGATGGTTCG -> AGCGACACGGACCAGATGGTTCGT
CTTACGGCTTACTTCCGGTAACCC -> TTACGGCTTACTTCCGGTAACCCG
GTCAAGACGCAAGTGTCGTCGCTA -> TCAAGACGCAAGTGTCGTCGCTAA
AGCTGGCGTAGCGATGCCATACAC -> GCTGGCGTAGCGATGCCATACACC
GAAGTCTGTTGTGAGACGACTTGA -> AAGTCTGTTGTGAGACGACTTGAC
TCTCCCACAAGCATACACGGTAAT -> CTCCCACAAGCATACACGGTAATC
ACCTGTCTTATTTGATATATCTGG -> CCTGTCTTATTTGATATATCTGGT
TCTTTCAGGATAAAAACATAGACA -> CTTTCAGGATAAAAACATAGACAT
ATTGTCACCATTTAGGCACGGAAC -> TTGTCACCATTTAGGCACGGAACG
GGGCTAGTTTAGCTCTGTACATGG -> GGCTAGTTTAGCTCTGTACATGGT
TGAGATCTCGGGGCGAGCGCAATG -> GAGATCTCGGGGCGAGCGCAATGC
CCACCATGTTCACACGCGTTTTGG -> CACCATGTTCACACGCGTTTTGGC
AGCGACACGGACCAGATGGTTCGT -> GCGACACGGACCAGATGGTTCGTA
AGAGTCATGGACACGGGCGTTGGC -> GAGTCATGGACACGGGCGTTGGCA
ATTCCAAGGAGAGGGAGCTGCAGC -> TTCCAAGGAGAGGGAGCTGCAGCA
ACATCTCCTAGCCTAGAAGGGCGT -> CATCTCCTAGCCTAGAAGGGCGTT
TTCTGGATGCACGCGCTGGGATTA -> TCTGGATGCACGCGCTGGGATTAT
CGGTCGACCAGTCAAGACGCAAGT -> GGTCGACCAGTCAAGACGCAAGTG
TTTGTATATGGAATCAGTCGTCGA -> TTGTATATGGAATCAGTCGTCGAG
ACATTCTGGATGCACGCGCTGGGA -> CATTCTGGATGCACGCGCTGGGAT
CCGCGCGCGGAAGGGTAGGGGACT -> CGCGCGCGGAAGGGTAGGGGACTC
GTGTCGTCGCTAAGGGGGCTGGTG -> TGTCGTCGCTAAGGGGGCTGGTGG
CCGACCTCTCCCACAAGCATACAC -> CGACCTCTCCCACAAGCATACACG
TATGGAATCAGTCGTCGAGGTGCG -> ATGGAATCAGTCGTCGAGGTGCGT
GTTACTCTCGCAGAGTCATGGACA -> TTACTCTCGCAGAGTCATGGACAC
ACCATGCCACCATGTTCACACGCG -> CCATGCCACCATGTTCACACGCGT
CAAGTATCTTACGTAATGACAGTT -> AAGTATCTTACGTAATGACAGTTA
CTGTCCAAGAGCCCTAATCGGAGC -> TGTCCAAGAGCCCTAATCGGAGCC
CAATATCTCTTACCATTGGGCTGT -> AATATCTCTTACCATTGGGCTGTA
AACAGGTCCTGCTCGCGAGTAAGA -> ACAGGTCCTGCTCGCGAGTAAGAC
CTGTACATCTCCTAGCCTAGAAGG -> TGTACATCTCCTAGCCTAGAAGGG
CCCGGGATCCTCCCGCCATGGGGT -> CCGGGATCCTCCCGCCATGGGGTA
TATCTGGTCCGGCCTTAGGGCTAG -> ATCTGGTCCGGCCTTAGGGCTAGT
GTGTATCGTCAACGTGTTGCCGTG -> TGTATCGTCAACGTGTTGCCGTGG
CTCCCACAAGCATACACGGTAATC -> TCCCACAAGCATACACGGTAATCC
ATGGACACGGGCGTTGGCATGACA -> TGGACACGGGCGTTGGCATGACAA
GGGCGTTACACCATGCCACCATGT -> GGCGTTACACCATGCCACCATGTT
TAGCCGTGTATCGTCAACGTGTTG -> AGCCGTGTATCGTCAACGTGTTGC
TGAGACGACTTGACCTTGAGATCT -> GAGACGACTTGACCTTGAGATCTC
CAATTGGGATGGCAGCTGGCGTAG -> AATTGGGATGGCAGCTGGCGTAGC
GCAGGATGATTCGGAGCCGAAATT -> CAGGATGATTCGGAGCCGAAATTC
CTAGTAACAGGTCCTGCTCGCGAG -> TAGTAACAGGTCCTGCTCGCGAGT
GCACCTGTCTTATTTGATATATCT -> CACCTGTCTTATTTGATATATCTG
AATATGCTGTCCAAGAGCCCTAAT -> ATATGCTGTCCAAGAGCCCTAATC
TGTATCGTCAACGTGTTGCCGTGG -> GTATCGTCAACGTGTTGCCGTGGC
GTTAGATATGCATTCGCCCGAAAT -> TTAGATATGCATTCGCCCGAAATA
CTAGAGCTTAACAATATCTCTTAC -> TAGAGCTTAACAATATCTCTTACC
GCCCTTGAGAAGTAGCCGTGTATC -> CCCTTGAGAAGTAGCCGTGTATCG
TAGACATGACCGAATCTGTAGCAT -> AGACATGACCGAATCTGTAGCATG
ACGCGTTTTGGCGCTCCACGGTTA -> CGCGTTTTGGCGCTCCACGGTTAT
TGTCCGACGCTTAGTGGATTTAGG -> GTCCGACGCTTAGTGGATTTAGGG
ACCAGTCAAGACGCAAGTGTCGTC -> CCAGTCAAGACGCAAGTGTCGTCG
CCGGTAGTATATACCTTGGTAAGT -> CGGTAGTATATACCTTGGTAAGTC
CGGTTTATGTACATATGGTAGCTG -> GGTTTATGTACATATGGTAGCTGC
TTCCTACGAGCCGACCTCTCCCAC -> TCCTACGAGCCGACCTCTCCCACA
AGGTCCTGCTCGCGAGTAAGACTA -> GGTCCTGCTCGCGAGTAAGACTAG
CTCCCGGGATCCTCCCGCCATGGG -> TCCCGGGATCCTCCCGCCATGGGG
TTCTGCTACGGAGAAAGCCCGTTA -> TCTGCTACGGAGAAAGCCCGTTAT
TGCTGTCCAAGAGCCCTAATCGGA -> GCTGTCCAAGAGCCCTAATCGGAG
CGCGCTGGGATTATGGCGATGGTA -> GCGCTGGGATTATGGCGATGGTAA
CCACGGTTATCACCGTCCTGAGCT -> CACGGTTATCACCGTCCTGAGCTT
ATGCACGCGCTGGGATTATGGCGA -> TGCACGCGCTGGGATTATGGCGAT
TCCTGCTCGCGAGTAAGACTAGAT -> CCTGCTCGCGAGTAAGACTAGATG
TGCCGTGGCGTGTCTTTTCAACTA -> GCCGTGGCGTGTCTTTTCAACTAT
CGGTATAGCACCTGTCTTATTTGA -> GGTATAGCACCTGTCTTATTTGAT
TTTTTCGCAGTACTAGAGCTTAAC -> TTTTCGCAGTACTAGAGCTTAACA
GCGAGCGCAATGCTCCTTCGTAAA -> CGAGCGCAATGCTCCTTCGTAAAG
TCAACAGGTTAGATATGCATTCGC -> CAACAGGTTAGATATGCATTCGCC
ATGGTCTGAGGTAACTCCTACGTA -> TGGTCTGAGGTAACTCCTACGTAG
CAGGTTAGATATGCATTCGCCCGA -> AGGTTAGATATGCATTCGCCCGAA
TGACAAAGGCGGATGTCTGGTGAT -> GACAAAGGCGGATGTCTGGTGATT
GAATTCACGAAACTATTAGCGTGT -> AATTCACGAAACTATTAGCGTGTA
GAATCAGTCGTCGAGGTGCGTACT -> AATCAGTCGTCGAGGTGCGTACTG
TATACCTTGGTAAGTCGATAACTT -> ATACCTTGGTAAGTCGATAACTTG
AGAAGTAGCCGTGTATCGTCAACG -> GAAGTAGCCGTGTATCGTCAACGT
TCTGAGGTAACTCCTACGTAGGCA -> CTGAGGTAACTCCTACGTAGGCAA
TTCTTTCAGGATAAAAACATAGAC -> TCTTTCAGGATAAAAACATAGACA
AAGGACTGTGATTCAGCCCATCAG -> AGGACTGTGATTCAGCCCATCAGC
TACGAACTAGAGCTGTCAGCGACA -> ACGAACTAGAGCTGTCAGCGACAC
AATCCGGAGTAGCCAAACCTTCTA -> ATCCGGAGTAGCCAAACCTTCTAG
CGACACGGACCAGATGGTTCGTAA -> GACACGGACCAGATGGTTCGTAAT
CTGAGGTAACTCCTACGTAGGCAA -> TGAGGTAACTCCTACGTAGGCAAT
TCAACGTGTTGCCGTGGCGTGTCT -> CAACGTGTTGCCGTGGCGTGTCTT
AGACGACTTGACCTTGAGATCTCG -> GACGACTTGACCTTGAGATCTCGG
GGTGGAGACCGCTGGGTCGTCCGC -> GTGGAGACCGCTGGGTCGTCCGCA
CCGCGGCTCGGAAGTCTGTTGTGA -> CGCGGCTCGGAAGTCTGTTGTGAG
TTTCTCGGAGAGAACCTGAAACCG -> TTCTCGGAGAGAACCTGAAACCGG
TCCTACGAGCCGACCTCTCCCACA -> CCTACGAGCCGACCTCTCCCACAA
TAGGCACGGAACGACCCACGTATA -> AGGCACGGAACGACCCACGTATAG
AGATGATCGACTGCGAGACAATGC -> GATGATCGACTGCGAGACAATGCG
TCGAGGTGCGTACTGATTTCACAC -> CGAGGTGCGTACTGATTTCACACC
TCTCAACTGTTAATCCGGAGTAGC -> CTCAACTGTTAATCCGGAGTAGCC
TGCCTACTGCGACATACCTTGGAC -> GCCTACTGCGACATACCTTGGACC
GCTGGGTCGTCCGCACGTGATTGA -> CTGGGTCGTCCGCACGTGATTGAA
TTAGGGCTAGTTTAGCTCTGTACA -> TAGGGCTAGTTTAGCTCTGTACAT
TACGAGCCGACCTCTCCCACAAGC -> ACGAGCCGACCTCTCCCACAAGCA
TAAGGGGGCTGGTGGAGACCGCTG -> AAGGGGGCTGGTGGAGACCGCTGG
ACATATGGTAGCTGCTCTTTATTC -> CATATGGTAGCTGCTCTTTATTCC
GTCAACGTGTTGCCGTGGCGTGTC -> TCAACGTGTTGCCGTGGCGTGTCT
GGACACGGGCGTTGGCATGACAAA -> GACACGGGCGTTGGCATGACAAAG
GAGACGACTTGACCTTGAGATCTC -> AGACGACTTGACCTTGAGATCTCG
CAGGTCCTGCTCGCGAGTAAGACT -> AGGTCCTGCTCGCGAGTAAGACTA
ATAGCAGACTCTTCAGTATACTAA -> TAGCAGACTCTTCAGTATACTAAA
GGATTTAGGGCCCTACATTCTGGA -> GATTTAGGGCCCTACATTCTGGAT
GTAAGACTAGATGATCGACTGCGA -> TAAGACTAGATGATCGACTGCGAG
CTCGGGGCGAGCGCAATGCTCCTT -> TCGGGGCGAGCGCAATGCTCCTTC
GGAGTAGCCAAACCTTCTAGTAAC -> GAGTAGCCAAACCTTCTAGTAACA
TCTGGTCCGGCCTTAGGGCTAGTT -> CTGGTCCGGCCTTAGGGCTAGTTT
ACGCAAGTGTCGTCGCTAAGGGGG -> CGCAAGTGTCGTCGCTAAGGGGGC
TGCTCCTTCGTAAAGAATTCACGA -> GCTCCTTCGTAAAGAATTCACGAA
GATGGCAGCTGGCGTAGCGATGCC -> ATGGCAGCTGGCGTAGCGATGCCA
TGGACACGGGCGTTGGCATGACAA -> GGACACGGGCGTTGGCATGACAAA
ATTGGCCTGGGGAACCCATCATTA -> TTGGCCTGGGGAACCCATCATTAA
ACCTTGGTAAGTCGATAACTTGTG -> CCTTGGTAAGTCGATAACTTGTGC
CGTTTGTATATGGAATCAGTCGTC -> GTTTGTATATGGAATCAGTCGTCG
ACAGAATACGGCGTTTGTATATGG -> CAGAATACGGCGTTTGTATATGGA
AGACTCTTCAGTATACTAAAATCC -> GACTCTTCAGTATACTAAAATCCT
CTGTCTTATTTGATATATCTGGTC -> TGTCTTATTTGATATATCTGGTCC
CACGGTAATCCTAAGGACTGTGAT -> ACGGTAATCCTAAGGACTGTGATT
CCGTTATATCCTATGCATGCTTTC -> CGTTATATCCTATGCATGCTTTCG
AGTATATACCTTGGTAAGTCGATA -> GTATATACCTTGGTAAGTCGATAA
GTAGGCAATTGGGATGGCAGCTGG -> TAGGCAATTGGGATGGCAGCTGGC
CGGAGAGAACCTGAAACCGGTTTA -> GGAGAGAACCTGAAACCGGTTTAT
GAGGGAGCTGCAGCACGGAATGAG -> AGGGAGCTGCAGCACGGAATGAGA
TTTGATATATCTGGTCCGGCCTTA -> TTGATATATCTGGTCCGGCCTTAG
TCGCGAGTAAGACTAGATGATCGA -> CGCGAGTAAGACTAGATGATCGAC
ACTGCAAGTATCTTACGTAATGAC -> CTGCAAGTATCTTACGTAATGACA
GAGTAGCCAAACCTTCTAGTAACA -> AGTAGCCAAACCTTCTAGTAACAG
ACGGAGAAAGCCCGTTATATCCTA -> CGGAGAAAGCCCGTTATATCCTAT
CTGCGACATACCTTGGACCGGTCG -> TGCGACATACCTTGGACCGGTCGA
ATCTATGCAGAGACAACGTGCTAG -> TCTATGCAGAGACAACGTGCTAGC
ACACCTTCTGCTACGGAGAAAGCC -> CACCTTCTGCTACGGAGAAAGCCC
GACAATGCGGTTACTCTCGCAGAG -> ACAATGCGGTTACTCTCGCAGAGT
CTCGCGAGTAAGACTAGATGATCG -> TCGCGAGTAAGACTAGATGATCGA
CGCGCCGTACACACTAGCCCTTGA -> GCGCCGTACACACTAGCCCTTGAG
CTGTTAATCCGGAGTAGCCAAACC -> TGTTAATCCGGAGTAGCCAAACCT
TCTTATTTGATATATCTGGTCCGG -> CTTATTTGATATATCTGGTCCGGC
ACCGCTGGGTCGTCCGCACGTGAT -> CCGCTGGGTCGTCCGCACGTGATT
ACCCGGTAGTATATACCTTGGTAA -> CCCGGTAGTATATACCTTGGTAAG
GATTTAGGGCCCTACATTCTGGAT -> ATTTAGGGCCCTACATTCTGGATG
GATTAATTAGTATTCCAAGGAGAG -> ATTAATTAGTATTCCAAGGAGAGG
GATCTCGGGGCGAGCGCAATGCTC -> ATCTCGGGGCGAGCGCAATGCTCC
CTGGGTCGTCCGCACGTGATTGAA -> TGGGTCGTCCGCACGTGATTGAAT
TATCTTACACCATTTTTTCGCAGT -> ATCTTACACCATTTTTTCGCAGTA
TTTATGTACATATGGTAGCTGCTC -> TTATGTACATATGGTAGCTGCTCT
GGCGCTCCACGGTTATCACCGTCC -> GCGCTCCACGGTTATCACCGTCCT
AGAAAGCCCGTTATATCCTATGCA -> GAAAGCCCGTTATATCCTATGCAT
CGGCGTTTGTATATGGAATCAGTC -> GGCGTTTGTATATGGAATCAGTCG
GCTACGGAGAAAGCCCGTTATATC -> CTACGGAGAAAGCCCGTTATATCC
GGGGACTCCGATTAATTAGTATTC -> GGGACTCCGATTAATTAGTATTCC
TGGTAGCTGCTCTTTATTCCGGTA -> GGTAGCTGCTCTTTATTCCGGTAT
CGGTTATCACCGTCCTGAGCTTGC -> GGTTATCACCGTCCTGAGCTTGCC
CGCAAGTGTCGTCGCTAAGGGGGC -> GCAAGTGTCGTCGCTAAGGGGGCT
TGGGTCGTCCGCACGTGATTGAAT -> GGGTCGTCCGCACGTGATTGAATG
AATTGCATGGTCTGAGGTAACTCC -> ATTGCATGGTCTGAGGTAACTCCT
CCGGAGATTGGACCGCGGCTCGGA -> CGGAGATTGGACCGCGGCTCGGAA
GTCGCTAAGGGGGCTGGTGGAGAC -> TCGCTAAGGGGGCTGGTGGAGACC
AAATTGCATGGTCTGAGGTAACTC -> AATTGCATGGTCTGAGGTAACTCC
AGCCCTTGAGAAGTAGCCGTGTAT -> GCCCTTGAGAAGTAGCCGTGTATC
GATATGCATTCGCCCGAAATATGC -> ATATGCATTCGCCCGAAATATGCT
CCCATCATTAAAGTTATGCCACTC -> CCATCATTAAAGTTATGCCACTCC
AGCTTAGGTTTGCGCCGCGCGCGG -> GCTTAGGTTTGCGCCGCGCGCGGA
AGGGGACTCCGATTAATTAGTATT -> GGGGACTCCGATTAATTAGTATTC
GACTTACGGCTTACTTCCGGTAAC -> ACTTACGGCTTACTTCCGGTAACC
TTAGCGTGTACGGCCTTTCTCGGA -> TAGCGTGTACGGCCTTTCTCGGAG
CGTGTACGGCCTTTCTCGGAGAGA -> GTGTACGGCCTTTCTCGGAGAGAA
CCTGAAACCGGTTTATGTACATAT -> CTGAAACCGGTTTATGTACATATG
TCGACCAGTCAAGACGCAAGTGTC -> CGACCAGTCAAGACGCAAGTGTCG
CGGTTACTCTCGCAGAGTCATGGA -> GGTTACTCTCGCAGAGTCATGGAC
CTCAACTGTTAATCCGGAGTAGCC -> TCAACTGTTAATCCGGAGTAGCCA
GCCATACACCACAGAATACGGCGT -> CCATACACCACAGAATACGGCGTT
AGTCGATAACTTGTGCAGGATGAT -> GTCGATAACTTGTGCAGGATGATT
CTAACCAGCGTTCATCCTCACAGA -> TAACCAGCGTTCATCCTCACAGAT
GTCTTTTCAACTATTGTCACCATT -> TCTTTTCAACTATTGTCACCATTT
TCGATAACTTGTGCAGGATGATTC -> CGATAACTTGTGCAGGATGATTCG
TCGACTGCGAGACAATGCGGTTAC -> CGACTGCGAGACAATGCGGTTACT
TAGCGTGTACGGCCTTTCTCGGAG -> AGCGTGTACGGCCTTTCTCGGAGA
ATATGCATTCGCCCGAAATATGCT -> TATGCATTCGCCCGAAATATGCTG
GTCTGGTGATTAGATCCGGAGATT -> TCTGGTGATTAGATCCGGAGATTG
TAATTAGTATTCCAAGGAGAGGGA -> AATTAGTATTCCAAGGAGAGGGAG
CAGAGACAACGTGCTAGCATTCTA -> AGAGACAACGTGCTAGCATTCTAG
CTTTCAGGATAAAAACATAGACAT -> TTTCAGGATAAAAACATAGACATG
CAGACTAGACTTACGGCTTACTTC -> AGACTAGACTTACGGCTTACTTCC
TCCTATGCATGCTTTCGATTGTCA -> CCTATGCATGCTTTCGATTGTCAA
TTACGTAATGACAGTTAACGGTGT -> TACGTAATGACAGTTAACGGTGTT
GACTAGACTTACGGCTTACTTCCG -> ACTAGACTTACGGCTTACTTCCGG
GCGAGTAAGACTAGATGATCGACT -> CGAGTAAGACTAGATGATCGACTG
TACACACTAGCCCTTGAGAAGTAG -> ACACACTAGCCCTTGAGAAGTAGC
TACGGAGAAAGCCCGTTATATCCT -> ACGGAGAAAGCCCGTTATATCCTA
TGCGCCGCGCGCGGAAGGGTAGGG -> GCGCCGCGCGCGGAAGGGTAGGGG
ATTGGGATGGCAGCTGGCGTAGCG -> TTGGGATGGCAGCTGGCGTAGCGA
AGAATTCACGAAACTATTAGCGTG -> GAATTCACGAAACTATTAGCGTGT
AAGTAGCCGTGTATCGTCAACGTG -> AGTAGCCGTGTATCGTCAACGTGT
CTAGAGCTGTCAGCGACACGGACC -> TAGAGCTGTCAGCGACACGGACCA
AGCTCTGTACATGGTGTTGCCTGT -> GCTCTGTACATGGTGTTGCCTGTA
CCTACATTCTGGATGCACGCGCTG -> CTACATTCTGGATGCACGCGCTGG
ACCGAATCTGTAGCATGTCCGACG -> CCGAATCTGTAGCATGTCCGACGC
ACGGACCAGATGGTTCGTAATTAT -> CGGACCAGATGGTTCGTAATTATC
CTTGTCTTCTTTCAGGATAAAAAC -> TTGTCTTCTTTCAGGATAAAAACA
GAGACCGCTGGGTCGTCCGCACGT -> AGACCGCTGGGTCGTCCGCACGTG
TCGTAATTATCTTACACCATTTTT -> CGTAATTATCTTACACCATTTTTT
TTGACCTTGAGATCTCGGGGCGAG -> TGACCTTGAGATCTCGGGGCGAGC
GCGTGTACGGCCTTTCTCGGAGAG -> CGTGTACGGCCTTTCTCGGAGAGA
TTCGTAATTATCTTACACCATTTT -> TCGTAATTATCTTACACCATTTTT
GATAAAAACATAGACATGACCGAA -> ATAAAAACATAGACATGACCGAAT
TATGCATGCTTTCGATTGTCAAAG -> ATGCATGCTTTCGATTGTCAAAGC
GCACGTGATTGAATGCTCCGCGGC -> CACGTGATTGAATGCTCCGCGGCT
GGCGAGCGCAATGCTCCTTCGTAA -> GCGAGCGCAATGCTCCTTCGTAAA
ATAACTTGTGCAGGATGATTCGGA -> TAACTTGTGCAGGATGATTCGGAG
GTCCGCACGTGATTGAATGCTCCG -> TCCGCACGTGATTGAATGCTCCGC
AGTTAACGGTGTTATCGGTCCATC -> GTTAACGGTGTTATCGGTCCATCT
CCGTCCTGAGCTTGCCTACTGCGA -> CGTCCTGAGCTTGCCTACTGCGAC
ATGTTCACACGCGTTTTGGCGCTC -> TGTTCACACGCGTTTTGGCGCTCC
TAGTAACAGGTCCTGCTCGCGAGT -> AGTAACAGGTCCTGCTCGCGAGTA
CATCTTCCTACGAGCCGACCTCTC -> ATCTTCCTACGAGCCGACCTCTCC
CCTTCGTAAAGAATTCACGAAACT -> CTTCGTAAAGAATTCACGAAACTA
GTGCAGGATGATTCGGAGCCGAAA -> TGCAGGATGATTCGGAGCCGAAAT
GTTGTGAGACGACTTGACCTTGAG -> TTGTGAGACGACTTGACCTTGAGA
CTTCTGCTACGGAGAAAGCCCGTT -> TTCTGCTACGGAGAAAGCCCGTTA
TCCTCACAGATGACAGACTAGACT -> CCTCACAGATGACAGACTAGACTT
CGCCGCGCGCGGAAGGGTAGGGGA -> GCCGCGCGCGGAAGGGTAGGGGAC
TGGTAAAAGCTAACCAGCGTTCAT -> GGTAAAAGCTAACCAGCGTTCATC
TAGCCAAACCTTCTAGTAACAGGT -> AGCCAAACCTTCTAGTAACAGGTC
TCTAGTAACAGGTCCTGCTCGCGA -> CTAGTAACAGGTCCTGCTCGCGAG
GCAAGTGTCGTCGCTAAGGGGGCT -> CAAGTGTCGTCGCTAAGGGGGCTG
CTTCTAGTAACAGGTCCTGCTCGC -> TTCTAGTAACAGGTCCTGCTCGCG
ATGGTAGCTGCTCTTTATTCCGGT -> TGGTAGCTGCTCTTTATTCCGGTA
TTATTTGATATATCTGGTCCGGCC -> TATTTGATATATCTGGTCCGGCCT
TCTTCCTACGAGCCGACCTCTCCC -> CTTCCTACGAGCCGACCTCTCCCA
AACTCCTACGTAGGCAATTGGGAT -> ACTCCTACGTAGGCAATTGGGATG
CACGCGTTTTGGCGCTCCACGGTT -> ACGCGTTTTGGCGCTCCACGGTTA
TACATCTCCTAGCCTAGAAGGGCG -> ACATCTCCTAGCCTAGAAGGGCGT
CTTGTGCAGGATGATTCGGAGCCG -> TTGTGCAGGATGATTCGGAGCCGA
GCGTTGGCATGACAAAGGCGGATG -> CGTTGGCATGACAAAGGCGGATGT
CCCTACATTCTGGATGCACGCGCT -> CCTACATTCTGGATGCACGCGCTG
TTCAGTATACTAAAATCCTACGAA -> TCAGTATACTAAAATCCTACGAAC
TACTCTCGCAGAGTCATGGACACG -> ACTCTCGCAGAGTCATGGACACGG
GAGATTGGACCGCGGCTCGGAAGT -> AGATTGGACCGCGGCTCGGAAGTC
AAAGCCCGTTATATCCTATGCATG -> AAGCCCGTTATATCCTATGCATGC
CCTTAGGGCTAGTTTAGCTCTGTA -> CTTAGGGCTAGTTTAGCTCTGTAC
TTAGTATTCCAAGGAGAGGGAGCT -> TAGTATTCCAAGGAGAGGGAGCTG
GGTGTTGCCTGTAACAGACTGCAA -> GTGTTGCCTGTAACAGACTGCAAG
ACCTTCTAGTAACAGGTCCTGCTC -> CCTTCTAGTAACAGGTCCTGCTCG
ATTAATTAGTATTCCAAGGAGAGG -> TTAATTAGTATTCCAAGGAGAGGG
GGCCTTTCTCGGAGAGAACCTGAA -> GCCTTTCTCGGAGAGAACCTGAAA
CAACGTGATTGGCCTGGGGAACCC -> AACGTGATTGGCCTGGGGAACCCA
GGTCGTCCGCACGTGATTGAATGC -> GTCGTCCGCACGTGATTGAATGCT
ACTAGAGCTGTCAGCGACACGGAC -> CTAGAGCTGTCAGCGACACGGACC
ATCTTACGTAATGACAGTTAACGG -> TCTTACGTAATGACAGTTAACGGT
GCCCGAAATATGCTGTCCAAGAGC -> CCCGAAATATGCTGTCCAAGAGCC
CTGGTGGAGACCGCTGGGTCGTCC -> TGGTGGAGACCGCTGGGTCGTCCG
TAGCATGTCCGACGCTTAGTGGAT -> AGCATGTCCGACGCTTAGTGGATT
TTAACAATATCTCTTACCATTGGG -> TAACAATATCTCTTACCATTGGGC
CCGCTGGGTCGTCCGCACGTGATT -> CGCTGGGTCGTCCGCACGTGATTG
TTGAATGCTCCGCGGCTTGTCTTC -> TGAATGCTCCGCGGCTTGTCTTCT
TTATGCCACTCCCGGGATCCTCCC -> TATGCCACTCCCGGGATCCTCCCG
CTTCAGTATACTAAAATCCTACGA -> TTCAGTATACTAAAATCCTACGAA
TACGTAGGCAATTGGGATGGCAGC -> ACGTAGGCAATTGGGATGGCAGCT
CTAGCCTAGAAGGGCGTTACACCA -> TAGCCTAGAAGGGCGTTACACCAT
GTTCGTAATTATCTTACACCATTT -> TTCGTAATTATCTTACACCATTTT
GTTATATCCTATGCATGCTTTCGA -> TTATATCCTATGCATGCTTTCGAT
TAGGCTACCCAACGTGATTGGCCT -> AGGCTACCCAACGTGATTGGCCTG
TTTGGCGCTCCACGGTTATCACCG -> TTGGCGCTCCACGGTTATCACCGT
CGTTATATCCTATGCATGCTTTCG -> GTTATATCCTATGCATGCTTTCGA
TAGCACCTGTCTTATTTGATATAT -> AGCACCTGTCTTATTTGATATATC
CAAACCTTCTAGTAACAGGTCCTG -> AAACCTTCTAGTAACAGGTCCTGC
GTACTAGAGCTTAACAATATCTCT -> TACTAGAGCTTAACAATATCTCTT
GAGCCGACCTCTCCCACAAGCATA -> AGCCGACCTCTCCCACAAGCATAC
TCATCCTCACAGATGACAGACTAG -> CATCCTCACAGATGACAGACTAGA
ATTAGCGTGTACGGCCTTTCTCGG -> TTAGCGTGTACGGCCTTTCTCGGA
ATACACCACAGAATACGGCGTTTG -> TACACCACAGAATACGGCGTTTGT
GAGCTGTCAGCGACACGGACCAGA -> AGCTGTCAGCGACACGGACCAGAT
TCTTACCATTGGGCTGTACATCTC -> CTTACCATTGGGCTGTACATCTCC
GACCGCGGCTCGGAAGTCTGTTGT -> ACCGCGGCTCGGAAGTCTGTTGTG
ATGATCGACTGCGAGACAATGCGG -> TGATCGACTGCGAGACAATGCGGT
CGGCTCGGAAGTCTGTTGTGAGAC -> GGCTCGGAAGTCTGTTGTGAGACG
CTATGCATGCTTTCGATTGTCAAA -> TATGCATGCTTTCGATTGTCAAAG
GCTGCTCTTTATTCCGGTATAGCA -> CTGCTCTTTATTCCGGTATAGCAC
AAAGCTAACCAGCGTTCATCCTCA -> AAGCTAACCAGCGTTCATCCTCAC
CGGAACGACCCACGTATAGCAGAC -> GGAACGACCCACGTATAGCAGACT
AGCCCGTTATATCCTATGCATGCT -> GCCCGTTATATCCTATGCATGCTT
CATTCTAGGCTACCCAACGTGATT -> ATTCTAGGCTACCCAACGTGATTG
TCTGTTGTGAGACGACTTGACCTT -> CTGTTGTGAGACGACTTGACCTTG
TCGGAGAGAACCTGAAACCGGTTT -> CGGAGAGAACCTGAAACCGGTTTA
GGTATAGCACCTGTCTTATTTGAT -> GTATAGCACCTGTCTTATTTGATA
GGACTGTGATTCAGCCCATCAGCT -> GACTGTGATTCAGCCCATCAGCTT
GTGGAGACCGCTGGGTCGTCCGCA -> TGGAGACCGCTGGGTCGTCCGCAC
TAGCTCTGTACATGGTGTTGCCTG -> AGCTCTGTACATGGTGTTGCCTGT
GTCGACCAGTCAAGACGCAAGTGT -> TCGACCAGTCAAGACGCAAGTGTC
TGGCGTGTCTTTTCAACTATTGTC -> GGCGTGTCTTTTCAACTATTGTCA
CGACTGCGAGACAATGCGGTTACT -> GACTGCGAGACAATGCGGTTACTC
AATCGGAGCCAGGTTGACGCGCCG -> ATCGGAGCCAGGTTGACGCGCCGT
AGCTGTCAGCGACACGGACCAGAT -> GCTGTCAGCGACACGGACCAGATG
TGTGATTCAGCCCATCAGCTTAGG -> GTGATTCAGCCCATCAGCTTAGGT
AGCCGTGTATCGTCAACGTGTTGC -> GCCGTGTATCGTCAACGTGTTGCC
ATGACAAAGGCGGATGTCTGGTGA -> TGACAAAGGCGGATGTCTGGTGAT
GCTAGTTTAGCTCTGTACATGGTG -> CTAGTTTAGCTCTGTACATGGTGT
TGCCACCATGTTCACACGCGTTTT -> GCCACCATGTTCACACGCGTTTTG
GTACACACTAGCCCTTGAGAAGTA -> TACACACTAGCCCTTGAGAAGTAG
CTCCTTCGTAAAGAATTCACGAAA -> TCCTTCGTAAAGAATTCACGAAAC
TCCAAGAGCCCTAATCGGAGCCAG -> CCAAGAGCCCTAATCGGAGCCAGG
ATTCGGAGCCGAAATTCTCAACTG -> TTCGGAGCCGAAATTCTCAACTGT
GATTAGATCCGGAGATTGGACCGC -> ATTAGATCCGGAGATTGGACCGCG
GCCTGGGGAACCCATCATTAAAGT -> CCTGGGGAACCCATCATTAAAGTT
GAAACTATTAGCGTGTACGGCCTT -> AAACTATTAGCGTGTACGGCCTTT
CGGTGTTATCGGTCCATCTTCCTA -> GGTGTTATCGGTCCATCTTCCTAC
GCCCGTTATATCCTATGCATGCTT -> CCCGTTATATCCTATGCATGCTTT
CGGCTTACTTCCGGTAACCCGGTA -> GGCTTACTTCCGGTAACCCGGTAG
GGAGAGAACCTGAAACCGGTTTAT -> GAGAGAACCTGAAACCGGTTTATG
GATAACTTGTGCAGGATGATTCGG -> ATAACTTGTGCAGGATGATTCGGA
GACCGAATCTGTAGCATGTCCGAC -> ACCGAATCTGTAGCATGTCCGACG
TAGGGGACTCCGATTAATTAGTAT -> AGGGGACTCCGATTAATTAGTATT
TCAACTATTGTCACCATTTAGGCA -> CAACTATTGTCACCATTTAGGCAC
AATTGGGATGGCAGCTGGCGTAGC -> ATTGGGATGGCAGCTGGCGTAGCG
CCGCGGCTTGTCTTCTTTCAGGAT -> CGCGGCTTGTCTTCTTTCAGGATA
TGCCTGTAACAGACTGCAAGTATC -> GCCTGTAACAGACTGCAAGTATCT
CGTTGGCATGACAAAGGCGGATGT -> GTTGGCATGACAAAGGCGGATGTC
CCTCTCCCACAAGCATACACGGTA -> CTCTCCCACAAGCATACACGGTAA
AGGTTAGATATGCATTCGCCCGAA -> GGTTAGATATGCATTCGCCCGAAA
GTTAATCCGGAGTAGCCAAACCTT -> TTAATCCGGAGTAGCCAAACCTTC
GCATTCGCCCGAAATATGCTGTCC -> CATTCGCCCGAAATATGCTGTCCA
CACACGCGTTTTGGCGCTCCACGG -> ACACGCGTTTTGGCGCTCCACGGT
GGATCCTCCCGCCATGGGGTAACC -> GATCCTCCCGCCATGGGGTAACCT
GAACCCATCATTAAAGTTATGCCA -> AACCCATCATTAAAGTTATGCCAC
TTCGTAAAGAATTCACGAAACTAT -> TCGTAAAGAATTCACGAAACTATT
AGGAGAGGGAGCTGCAGCACGGAA -> GGAGAGGGAGCTGCAGCACGGAAT
CAGGATGATTCGGAGCCGAAATTC -> AGGATGATTCGGAGCCGAAATTCT
TTGCGCCGCGCGCGGAAGGGTAGG -> TGCGCCGCGCGCGGAAGGGTAGGG
CGTACTGATTTCACACCTTCTGCT -> GTACTGATTTCACACCTTCTGCTA
CGGAGCCGAAATTCTCAACTGTTA -> GGAGCCGAAATTCTCAACTGTTAA
TTCAGGATAAAAACATAGACATGA -> TCAGGATAAAAACATAGACATGAC
ATCTCGGGGCGAGCGCAATGCTCC -> TCTCGGGGCGAGCGCAATGCTCCT
AGGTAACTCCTACGTAGGCAATTG -> GGTAACTCCTACGTAGGCAATTGG
TCCGCGGCTTGTCTTCTTTCAGGA -> CCGCGGCTTGTCTTCTTTCAGGAT
CCTAGAAGGGCGTTACACCATGCC -> CTAGAAGGGCGTTACACCATGCCA
GACAAAGGCGGATGTCTGGTGATT -> ACAAAGGCGGATGTCTGGTGATTA
GGCTTGTCTTCTTTCAGGATAAAA -> GCTTGTCTTCTTTCAGGATAAAAA
TAACGGTGTTATCGGTCCATCTTC -> AACGGTGTTATCGGTCCATCTTCC
TTTAGCTCTGTACATGGTGTTGCC -> TTAGCTCTGTACATGGTGTTGCCT
TAACAGGTCCTGCTCGCGAGTAAG -> AACAGGTCCTGCTCGCGAGTAAGA
CACCATTTAGGCACGGAACGACCC -> ACCATTTAGGCACGGAACGACCCA
TCAACTGTTAATCCGGAGTAGCCA -> CAACTGTTAATCCGGAGTAGCCAA
GTGAGACGACTTGACCTTGAGATC -> TGAGACGACTTGACCTTGAGATCT
TTACTTCCGGTAACCCGGTAGTAT -> TACTTCCGGTAACCCGGTAGTATA
GCTTGCCTACTGCGACATACCTTG -> CTTGCCTACTGCGACATACCTTGG
AATGAGAAATCTATGCAGAGACAA -> ATGAGAAATCTATGCAGAGACAAC
ATTCCGGTATAGCACCTGTCTTAT -> TTCCGGTATAGCACCTGTCTTATT
ATATGGTAGCTGCTCTTTATTCCG -> TATGGTAGCTGCTCTTTATTCCGG
ATCACCGTCCTGAGCTTGCCTACT -> TCACCGTCCTGAGCTTGCCTACTG
CCTACGAGCCGACCTCTCCCACAA -> CTACGAGCCGACCTCTCCCACAAG
ACAGACTGCAAGTATCTTACGTAA -> CAGACTGCAAGTATCTTACGTAAT
GGAATGAGAAATCTATGCAGAGAC -> GAATGAGAAATCTATGCAGAGACA
GTCTGAGGTAACTCCTACGTAGGC -> TCTGAGGTAACTCCTACGTAGGCA
AGGGTAGGGGACTCCGATTAATTA -> GGGTAGGGGACTCCGATTAATTAG
AGAATACGGCGTTTGTATATGGAA -> GAATACGGCGTTTGTATATGGAAT
TGATTGAATGCTCCGCGGCTTGTC -> GATTGAATGCTCCGCGGCTTGTCT
ACAATATCTCTTACCATTGGGCTG -> CAATATCTCTTACCATTGGGCTGT
TCTGTACATGGTGTTGCCTGTAAC -> CTGTACATGGTGTTGCCTGTAACA
CCATCTTCCTACGAGCCGACCTCT -> CATCTTCCTACGAGCCGACCTCTC
CCAGCGTTCATCCTCACAGATGAC -> CAGCGTTCATCCTCACAGATGACA
ATCCGGAGATTGGACCGCGGCTCG -> TCCGGAGATTGGACCGCGGCTCGG
TTAGGGCCCTACATTCTGGATGCA -> TAGGGCCCTACATTCTGGATGCAC
CGCCCGAAATATGCTGTCCAAGAG -> GCCCGAAATATGCTGTCCAAGAGC
CATCTCCTAGCCTAGAAGGGCGTT -> ATCTCCTAGCCTAGAAGGGCGTTA
TCCTACGTAGGCAATTGGGATGGC -> CCTACGTAGGCAATTGGGATGGCA
GCCGTGGCGTGTCTTTTCAACTAT -> CCGTGGCGTGTCTTTTCAACTATT
CTATGCAGAGACAACGTGCTAGCA -> TATGCAGAGACAACGTGCTAGCAT
ATCCTCACAGATGACAGACTAGAC -> TCCTCACAGATGACAGACTAGACT
GTTTAGCTCTGTACATGGTGTTGC -> TTTAGCTCTGTACATGGTGTTGCC
TCGGTCCATCTTCCTACGAGCCGA -> CGGTCCATCTTCCTACGAGCCGAC
CTTTTCAACTATTGTCACCATTTA -> TTTTCAACTATTGTCACCATTTAG
CCCAACGTGATTGGCCTGGGGAAC -> CCAACGTGATTGGCCTGGGGAACC
TAAAGAATTCACGAAACTATTAGC -> AAAGAATTCACGAAACTATTAGCG
ACAGGTCCTGCTCGCGAGTAAGAC -> CAGGTCCTGCTCGCGAGTAAGACT
CGTAAAGAATTCACGAAACTATTA -> GTAAAGAATTCACGAAACTATTAG
TACGGCGTTTGTATATGGAATCAG -> ACGGCGTTTGTATATGGAATCAGT
AGCATTCTAGGCTACCCAACGTGA -> GCATTCTAGGCTACCCAACGTGAT
CACCATTTTTTCGCAGTACTAGAG -> ACCATTTTTTCGCAGTACTAGAGC
CATGTCCGACGCTTAGTGGATTTA -> ATGTCCGACGCTTAGTGGATTTAG
TTCACACGCGTTTTGGCGCTCCAC -> TCACACGCGTTTTGGCGCTCCACG
TCCGCACGTGATTGAATGCTCCGC -> CCGCACGTGATTGAATGCTCCGCG
CTTATTTGATATATCTGGTCCGGC -> TTATTTGATATATCTGGTCCGGCC
ATTAGTATTCCAAGGAGAGGGAGC -> TTAGTATTCCAAGGAGAGGGAGCT
GTAAGTCGATAACTTGTGCAGGAT -> TAAGTCGATAACTTGTGCAGGATG
CGACTTGACCTTGAGATCTCGGGG -> GACTTGACCTTGAGATCTCGGGGC
GTTTGCGCCGCGCGCGGAAGGGTA -> TTTGCGCCGCGCGCGGAAGGGTAG
TAGCCTAGAAGGGCGTTACACCAT -> AGCCTAGAAGGGCGTTACACCATG
AGTTATGCCACTCCCGGGATCCTC -> GTTATGCCACTCCCGGGATCCTCC
CCGATTAATTAGTATTCCAAGGAG -> CGATTAATTAGTATTCCAAGGAGA
GCGGCTCGGAAGTCTGTTGTGAGA -> CGGCTCGGAAGTCTGTTGTGAGAC
ACCATTTAGGCACGGAACGACCCA -> CCATTTAGGCACGGAACGACCCAC
CTCCTACGTAGGCAATTGGGATGG -> TCCTACGTAGGCAATTGGGATGGC
GCGCGGAAGGGTAGGGGACTCCGA -> CGCGGAAGGGTAGGGGACTCCGAT
GGCACGGAACGACCCACGTATAGC -> GCACGGAACGACCCACGTATAGCA
TACGGCTTACTTCCGGTAACCCGG -> ACGGCTTACTTCCGGTAACCCGGT
ATCGGAGCCAGGTTGACGCGCCGT -> TCGGAGCCAGGTTGACGCGCCGTA
GAGAACCTGAAACCGGTTTATGTA -> AGAACCTGAAACCGGTTTATGTAC
CTCTCCCACAAGCATACACGGTAA -> TCTCCCACAAGCATACACGGTAAT
ACTTGTGCAGGATGATTCGGAGCC -> CTTGTGCAGGATGATTCGGAGCCG
CTCGGAAGTCTGTTGTGAGACGAC -> TCGGAAGTCTGTTGTGAGACGACT
ACGGCCTTTCTCGGAGAGAACCTG -> CGGCCTTTCTCGGAGAGAACCTGA
AGGGCCCTACATTCTGGATGCACG -> GGGCCCTACATTCTGGATGCACGC
TGGTGTTGCCTGTAACAGACTGCA -> GGTGTTGCCTGTAACAGACTGCAA
ACGCGCCGTACACACTAGCCCTTG -> CGCGCCGTACACACTAGCCCTTGA
CTACGAGCCGACCTCTCCCACAAG -> TACGAGCCGACCTCTCCCACAAGC
CGTCGAGGTGCGTACTGATTTCAC -> GTCGAGGTGCGTACTGATTTCACA
CGTCAACGTGTTGCCGTGGCGTGT -> GTCAACGTGTTGCCGTGGCGTGTC
AGCATGTCCGACGCTTAGTGGATT -> GCATGTCCGACGCTTAGTGGATTT
AGGCGGATGTCTGGTGATTAGATC -> GGCGGATGTCTGGTGATTAGATCC
GCGCTCCACGGTTATCACCGTCCT -> CGCTCCACGGTTATCACCGTCCTG
CTCCTAGCCTAGAAGGGCGTTACA -> TCCTAGCCTAGAAGGGCGTTACAC
ATCTTACACCATTTTTTCGCAGTA -> TCTTACACCATTTTTTCGCAGTAC
TATCGGTCCATCTTCCTACGAGCC -> ATCGGTCCATCTTCCTACGAGCCG
CAGGATAAAAACATAGACATGACC -> AGGATAAAAACATAGACATGACCG
TGAGAAATCTATGCAGAGACAACG -> GAGAAATCTATGCAGAGACAACGT
CATCATTAAAGTTATGCCACTCCC -> ATCATTAAAGTTATGCCACTCCCG
ATTATCTTACACCATTTTTTCGCA -> TTATCTTACACCATTTTTTCGCAG
GGAATCAGTCGTCGAGGTGCGTAC -> GAATCAGTCGTCGAGGTGCGTACT
GTACATCTCCTAGCCTAGAAGGGC -> TACATCTCCTAGCCTAGAAGGGCG
GACTCTTCAGTATACTAAAATCCT -> ACTCTTCAGTATACTAAAATCCTA
CGCAGAGTCATGGACACGGGCGTT -> GCAGAGTCATGGACACGGGCGTTG
GGGACTCCGATTAATTAGTATTCC -> GGACTCCGATTAATTAGTATTCCA
AGCACGGAATGAGAAATCTATGCA -> GCACGGAATGAGAAATCTATGCAG
CACTCCCGGGATCCTCCCGCCATG -> ACTCCCGGGATCCTCCCGCCATGG
GCGGTTACTCTCGCAGAGTCATGG -> CGGTTACTCTCGCAGAGTCATGGA
ATGTACATATGGTAGCTGCTCTTT -> TGTACATATGGTAGCTGCTCTTTA
GTAATCCTAAGGACTGTGATTCAG -> TAATCCTAAGGACTGTGATTCAGC
AGATGACAGACTAGACTTACGGCT -> GATGACAGACTAGACTTACGGCTT
TCGTAAAGAATTCACGAAACTATT -> CGTAAAGAATTCACGAAACTATTA
TTGTCTTCTTTCAGGATAAAAACA -> TGTCTTCTTTCAGGATAAAAACAT
TGTTGCCTGTAACAGACTGCAAGT -> GTTGCCTGTAACAGACTGCAAGTA
CTGCAAGTATCTTACGTAATGACA -> TGCAAGTATCTTACGTAATGACAG
TATCGTCAACGTGTTGCCGTGGCG -> ATCGTCAACGTGTTGCCGTGGCGT
AGAGCTTAACAATATCTCTTACCA -> GAGCTTAACAATATCTCTTACCAT
TACCATTGGGCTGTACATCTCCTA -> ACCATTGGGCTGTACATCTCCTAG
GCGTTACACCATGCCACCATGTTC -> CGTTACACCATGCCACCATGTTCA
CTTCGTAAAGAATTCACGAAACTA -> TTCGTAAAGAATTCACGAAACTAT
CACACTAGCCCTTGAGAAGTAGCC -> ACACTAGCCCTTGAGAAGTAGCCG
TACATTCTGGATGCACGCGCTGGG -> ACATTCTGGATGCACGCGCTGGGA
CGTAGGCAATTGGGATGGCAGCTG -> GTAGGCAATTGGGATGGCAGCTGG
TCAGCTTAGGTTTGCGCCGCGCGC -> CAGCTTAGGTTTGCGCCGCGCGCG
ATCGGTCCATCTTCCTACGAGCCG -> TCGGTCCATCTTCCTACGAGCCGA
TTACCATTGGGCTGTACATCTCCT -> TACCATTGGGCTGTACATCTCCTA
ATGCCATACACCACAGAATACGGC -> TGCCATACACCACAGAATACGGCG
ACACGGTAATCCTAAGGACTGTGA -> CACGGTAATCCTAAGGACTGTGAT
TATTCCAAGGAGAGGGAGCTGCAG -> ATTCCAAGGAGAGGGAGCTGCAGC
TTACACCATTTTTTCGCAGTACTA -> TACACCATTTTTTCGCAGTACTAG
GACGCAAGTGTCGTCGCTAAGGGG -> ACGCAAGTGTCGTCGCTAAGGGGG
TTCCAAGGAGAGGGAGCTGCAGCA -> TCCAAGGAGAGGGAGCTGCAGCAC
TGAGCTTGCCTACTGCGACATACC -> GAGCTTGCCTACTGCGACATACCT
CGGAATGAGAAATCTATGCAGAGA -> GGAATGAGAAATCTATGCAGAGAC
CCAACGTGATTGGCCTGGGGAACC -> CAACGTGATTGGCCTGGGGAACCC
CTGCTACGGAGAAAGCCCGTTATA -> TGCTACGGAGAAAGCCCGTTATAT
GCATACACGGTAATCCTAAGGACT -> CATACACGGTAATCCTAAGGACTG
GAAAGCCCGTTATATCCTATGCAT -> AAAGCCCGTTATATCCTATGCATG
GCTTAACAATATCTCTTACCATTG -> CTTAACAATATCTCTTACCATTGG
CCATACACCACAGAATACGGCGTT -> CATACACCACAGAATACGGCGTTT
CTTAGTGGATTTAGGGCCCTACAT -> TTAGTGGATTTAGGGCCCTACATT
ACGTGCTAGCATTCTAGGCTACCC -> CGTGCTAGCATTCTAGGCTACCCA
AAAGTTATGCCACTCCCGGGATCC -> AAGTTATGCCACTCCCGGGATCCT
TAGAAGGGCGTTACACCATGCCAC -> AGAAGGGCGTTACACCATGCCACC
AAGCATACACGGTAATCCTAAGGA -> AGCATACACGGTAATCCTAAGGAC
GGATAAAAACATAGACATGACCGA -> GATAAAAACATAGACATGACCGAA
GCGATGCCATACACCACAGAATAC -> CGATGCCATACACCACAGAATACG
AAGTCTGTTGTGAGACGACTTGAC -> AGTCTGTTGTGAGACGACTTGACC
ATGAGAAATCTATGCAGAGACAAC -> TGAGAAATCTATGCAGAGACAACG
GCCGTACACACTAGCCCTTGAGAA -> CCGTACACACTAGCCCTTGAGAAG
ATCGACTGCGAGACAATGCGGTTA -> TCGACTGCGAGACAATGCGGTTAC
TGTAGCATGTCCGACGCTTAGTGG -> GTAGCATGTCCGACGCTTAGTGGA
CACTAGCCCTTGAGAAGTAGCCGT -> ACTAGCCCTTGAGAAGTAGCCGTG
GGGCTGGTGGAGACCGCTGGGTCG -> GGCTGGTGGAGACCGCTGGGTCGT
CGGGGCGAGCGCAATGCTCCTTCG -> GGGGCGAGCGCAATGCTCCTTCGT
GAAATCTATGCAGAGACAACGTGC -> AAATCTATGCAGAGACAACGTGCT
CGTGTATCGTCAACGTGTTGCCGT -> GTGTATCGTCAACGTGTTGCCGTG
CTTAGGTTTGCGCCGCGCGCGGAA -> TTAGGTTTGCGCCGCGCGCGGAAG
CCTAATCGGAGCCAGGTTGACGCG -> CTAATCGGAGCCAGGTTGACGCGC
GTTGACGCGCCGTACACACTAGCC -> TTGACGCGCCGTACACACTAGCCC
CGCGTTTTGGCGCTCCACGGTTAT -> GCGTTTTGGCGCTCCACGGTTATC
TACATATGGTAGCTGCTCTTTATT -> ACATATGGTAGCTGCTCTTTATTC
CGGAGATTGGACCGCGGCTCGGAA -> GGAGATTGGACCGCGGCTCGGAAG
TGGACCGCGGCTCGGAAGTCTGTT -> GGACCGCGGCTCGGAAGTCTGTTG
CAGACTCTTCAGTATACTAAAATC -> AGACTCTTCAGTATACTAAAATCC
CGACCCACGTATAGCAGACTCTTC -> GACCCACGTATAGCAGACTCTTCA
ACCATTTTTTCGCAGTACTAGAGC -> CCATTTTTTCGCAGTACTAGAGCT
TAATCCTAAGGACTGTGATTCAGC -> AATCCTAAGGACTGTGATTCAGCC
CTCGCAGAGTCATGGACACGGGCG -> TCGCAGAGTCATGGACACGGGCGT
GTTACACCATGCCACCATGTTCAC -> TTACACCATGCCACCATGTTCACA
AGCACCTGTCTTATTTGATATATC -> GCACCTGTCTTATTTGATATATCT
TTTGCGCCGCGCGCGGAAGGGTAG -> TTGCGCCGCGCGCGGAAGGGTAGG
AGGTTGACGCGCCGTACACACTAG -> GGTTGACGCGCCGTACACACTAGC
AATGCTCCGCGGCTTGTCTTCTTT -> ATGCTCCGCGGCTTGTCTTCTTTC
GTATATGGAATCAGTCGTCGAGGT -> TATATGGAATCAGTCGTCGAGGTG
GTAGCCAAACCTTCTAGTAACAGG -> TAGCCAAACCTTCTAGTAACAGGT
GTCGTCCGCACGTGATTGAATGCT -> TCGTCCGCACGTGATTGAATGCTC
TGTACATGGTGTTGCCTGTAACAG -> GTACATGGTGTTGCCTGTAACAGA
CCGTGGCGTGTCTTTTCAACTATT -> CGTGGCGTGTCTTTTCAACTATTG
GGAAGGGTAGGGGACTCCGATTAA -> GAAGGGTAGGGGACTCCGATTAAT
TGGCAGCTGGCGTAGCGATGCCAT -> GGCAGCTGGCGTAGCGATGCCATA
GCAGTACTAGAGCTTAACAATATC -> CAGTACTAGAGCTTAACAATATCT
GGCTACCCAACGTGATTGGCCTGG -> GCTACCCAACGTGATTGGCCTGGG
GGCGTTTGTATATGGAATCAGTCG -> GCGTTTGTATATGGAATCAGTCGT
GGAGATTGGACCGCGGCTCGGAAG -> GAGATTGGACCGCGGCTCGGAAGT
CATTTAGGCACGGAACGACCCACG -> ATTTAGGCACGGAACGACCCACGT
GGAAGTCTGTTGTGAGACGACTTG -> GAAGTCTGTTGTGAGACGACTTGA
CTGGTGATTAGATCCGGAGATTGG -> TGGTGATTAGATCCGGAGATTGGA
GTAACCTAAATTGCATGGTCTGAG -> TAACCTAAATTGCATGGTCTGAGG
GAGCCAGGTTGACGCGCCGTACAC -> AGCCAGGTTGACGCGCCGTACACA
CGGTCCATCTTCCTACGAGCCGAC -> GGTCCATCTTCCTACGAGCCGACC
TTATCACCGTCCTGAGCTTGCCTA -> TATCACCGTCCTGAGCTTGCCTAC
TCCTCCCGCCATGGGGTAACCTAA -> CCTCCCGCCATGGGGTAACCTAAA
TTTTTTCGCAGTACTAGAGCTTAA -> TTTTTCGCAGTACTAGAGCTTAAC
GTCTTCTTTCAGGATAAAAACATA -> TCTTCTTTCAGGATAAAAACATAG
ACCGCGGCTCGGAAGTCTGTTGTG -> CCGCGGCTCGGAAGTCTGTTGTGA
TAGCGATGCCATACACCACAGAAT -> AGCGATGCCATACACCACAGAATA
TAGAGCTGTCAGCGACACGGACCA -> AGAGCTGTCAGCGACACGGACCAG
TAGGCAATTGGGATGGCAGCTGGC -> AGGCAATTGGGATGGCAGCTGGCG
GAGTCATGGACACGGGCGTTGGCA -> AGTCATGGACACGGGCGTTGGCAT
CTTTCTCGGAGAGAACCTGAAACC -> TTTCTCGGAGAGAACCTGAAACCG
CTCTGTACATGGTGTTGCCTGTAA -> TCTGTACATGGTGTTGCCTGTAAC
GGTCTGAGGTAACTCCTACGTAGG -> GTCTGAGGTAACTCCTACGTAGGC
CAGTCGTCGAGGTGCGTACTGATT -> AGTCGTCGAGGTGCGTACTGATTT
AGCTGCTCTTTATTCCGGTATAGC -> GCTGCTCTTTATTCCGGTATAGCA
TTCAGCCCATCAGCTTAGGTTTGC -> TCAGCCCATCAGCTTAGGTTTGCG
CCGGGATCCTCCCGCCATGGGGTA -> CGGGATCCTCCCGCCATGGGGTAA
CAGTATACTAAAATCCTACGAACT -> AGTATACTAAAATCCTACGAACTA
CACGTATAGCAGACTCTTCAGTAT -> ACGTATAGCAGACTCTTCAGTATA
GACCTTGAGATCTCGGGGCGAGCG -> ACCTTGAGATCTCGGGGCGAGCGC
GAACCTGAAACCGGTTTATGTACA -> AACCTGAAACCGGTTTATGTACAT
CAGATGACAGACTAGACTTACGGC -> AGATGACAGACTAGACTTACGGCT
ATGATTCGGAGCCGAAATTCTCAA -> TGATTCGGAGCCGAAATTCTCAAC
CCGGCCTTAGGGCTAGTTTAGCTC -> CGGCCTTAGGGCTAGTTTAGCTCT
TCCTAGCCTAGAAGGGCGTTACAC -> CCTAGCCTAGAAGGGCGTTACACC
AGATCCGGAGATTGGACCGCGGCT -> GATCCGGAGATTGGACCGCGGCTC
TCTGCTACGGAGAAAGCCCGTTAT -> CTGCTACGGAGAAAGCCCGTTATA
GACAGTTAACGGTGTTATCGGTCC -> ACAGTTAACGGTGTTATCGGTCCA
CTACGTAGGCAATTGGGATGGCAG -> TACGTAGGCAATTGGGATGGCAGC
CACCTTCTGCTACGGAGAAAGCCC -> ACCTTCTGCTACGGAGAAAGCCCG
GCAATGCTCCTTCGTAAAGAATTC -> CAATGCTCCTTCGTAAAGAATTCA
CGCCATGGGGTAACCTAAATTGCA -> GCCATGGGGTAACCTAAATTGCAT
CTGCGAGACAATGCGGTTACTCTC -> TGCGAGACAATGCGGTTACTCTCG
CCGTGTATCGTCAACGTGTTGCCG -> CGTGTATCGTCAACGTGTTGCCGT
ACACCATGCCACCATGTTCACACG -> CACCATGCCACCATGTTCACACGC
CCTGAGCTTGCCTACTGCGACATA -> CTGAGCTTGCCTACTGCGACATAC
TCACGAAACTATTAGCGTGTACGG -> CACGAAACTATTAGCGTGTACGGC
AGTCTGTTGTGAGACGACTTGACC -> GTCTGTTGTGAGACGACTTGACCT
CGACATACCTTGGACCGGTCGACC -> GACATACCTTGGACCGGTCGACCA
CAACTGTTAATCCGGAGTAGCCAA -> AACTGTTAATCCGGAGTAGCCAAA
AGATGGTTCGTAATTATCTTACAC -> GATGGTTCGTAATTATCTTACACC
CGTCCTGAGCTTGCCTACTGCGAC -> GTCCTGAGCTTGCCTACTGCGACA
CTGTACATGGTGTTGCCTGTAACA -> TGTACATGGTGTTGCCTGTAACAG
TTGGTAAGTCGATAACTTGTGCAG -> TGGTAAGTCGATAACTTGTGCAGG
CCCGGTAGTATATACCTTGGTAAG -> CCGGTAGTATATACCTTGGTAAGT
TGATTCAGCCCATCAGCTTAGGTT -> GATTCAGCCCATCAGCTTAGGTTT
AGTCATGGACACGGGCGTTGGCAT -> GTCATGGACACGGGCGTTGGCATG
TTCGCCCGAAATATGCTGTCCAAG -> TCGCCCGAAATATGCTGTCCAAGA
GTAGCGATGCCATACACCACAGAA -> TAGCGATGCCATACACCACAGAAT
CGATGCCATACACCACAGAATACG -> GATGCCATACACCACAGAATACGG
CTGTAGCATGTCCGACGCTTAGTG -> TGTAGCATGTCCGACGCTTAGTGG
ATTATGGCGATGGTAAAAGCTAAC -> TTATGGCGATGGTAAAAGCTAACC
GTATTCCAAGGAGAGGGAGCTGCA -> TATTCCAAGGAGAGGGAGCTGCAG
CAGCGTTCATCCTCACAGATGACA -> AGCGTTCATCCTCACAGATGACAG
TACACCATGCCACCATGTTCACAC -> ACACCATGCCACCATGTTCACACG
TCTCTTACCATTGGGCTGTACATC -> CTCTTACCATTGGGCTGTACATCT
AGACGCAAGTGTCGTCGCTAAGGG -> GACGCAAGTGTCGTCGCTAAGGGG
GTTGGCATGACAAAGGCGGATGTC -> TTGGCATGACAAAGGCGGATGTCT
TGACAGACTAGACTTACGGCTTAC -> GACAGACTAGACTTACGGCTTACT
GTCAGCGACACGGACCAGATGGTT -> TCAGCGACACGGACCAGATGGTTC
CTGGGATTATGGCGATGGTAAAAG -> TGGGATTATGGCGATGGTAAAAGC
TCACCATTTAGGCACGGAACGACC -> CACCATTTAGGCACGGAACGACCC
GATTATGGCGATGGTAAAAGCTAA -> ATTATGGCGATGGTAAAAGCTAAC
TGCAGCACGGAATGAGAAATCTAT -> GCAGCACGGAATGAGAAATCTATG
CTTAGGGCTAGTTTAGCTCTGTAC -> TTAGGGCTAGTTTAGCTCTGTACA
TGTATATGGAATCAGTCGTCGAGG -> GTATATGGAATCAGTCGTCGAGGT
AAGTGTCGTCGCTAAGGGGGCTGG -> AGTGTCGTCGCTAAGGGGGCTGGT
CCAGTCAAGACGCAAGTGTCGTCG -> CAGTCAAGACGCAAGTGTCGTCGC
CGTCGCTAAGGGGGCTGGTGGAGA -> GTCGCTAAGGGGGCTGGTGGAGAC
ACTAGCCCTTGAGAAGTAGCCGTG -> CTAGCCCTTGAGAAGTAGCCGTGT
ACGTGATTGAATGCTCCGCGGCTT -> CGTGATTGAATGCTCCGCGGCTTG
ATCCTACGAACTAGAGCTGTCAGC -> TCCTACGAACTAGAGCTGTCAGCG
TAAATTGCATGGTCTGAGGTAACT -> AAATTGCATGGTCTGAGGTAACTC
TCGTCAACGTGTTGCCGTGGCGTG -> CGTCAACGTGTTGCCGTGGCGTGT
GGGAGCTGCAGCACGGAATGAGAA -> GGAGCTGCAGCACGGAATGAGAAA
GGCTGTACATCTCCTAGCCTAGAA -> GCTGTACATCTCCTAGCCTAGAAG
TTTCGCAGTACTAGAGCTTAACAA -> TTCGCAGTACTAGAGCTTAACAAT
TTACGGCTTACTTCCGGTAACCCG -> TACGGCTTACTTCCGGTAACCCGG
GTAAAGAATTCACGAAACTATTAG -> TAAAGAATTCACGAAACTATTAGC
TGCATGCTTTCGATTGTCAAAGCC -> GCATGCTTTCGATTGTCAAAGCCC
GTCGATAACTTGTGCAGGATGATT -> TCGATAACTTGTGCAGGATGATTC
GTCCTGCTCGCGAGTAAGACTAGA -> TCCTGCTCGCGAGTAAGACTAGAT
GAGACAATGCGGTTACTCTCGCAG -> AGACAATGCGGTTACTCTCGCAGA
GTAGCTGCTCTTTATTCCGGTATA -> TAGCTGCTCTTTATTCCGGTATAG
AAGACTAGATGATCGACTGCGAGA -> AGACTAGATGATCGACTGCGAGAC
GCCGCGCGCGGAAGGGTAGGGGAC -> CCGCGCGCGGAAGGGTAGGGGACT
CATGACCGAATCTGTAGCATGTCC -> ATGACCGAATCTGTAGCATGTCCG
ACTCCTACGTAGGCAATTGGGATG -> CTCCTACGTAGGCAATTGGGATGG
AATGACAGTTAACGGTGTTATCGG -> ATGACAGTTAACGGTGTTATCGGT
GAGCTGCAGCACGGAATGAGAAAT -> AGCTGCAGCACGGAATGAGAAATC
CATTAAAGTTATGCCACTCCCGGG -> ATTAAAGTTATGCCACTCCCGGGA
AACTATTAGCGTGTACGGCCTTTC -> ACTATTAGCGTGTACGGCCTTTCT
TATCTTACGTAATGACAGTTAACG -> ATCTTACGTAATGACAGTTAACGG
CTCACAGATGACAGACTAGACTTA -> TCACAGATGACAGACTAGACTTAC
TTTCAACTATTGTCACCATTTAGG -> TTCAACTATTGTCACCATTTAGGC
CCTATGCATGCTTTCGATTGTCAA -> CTATGCATGCTTTCGATTGTCAAA
ACCCACGTATAGCAGACTCTTCAG -> CCCACGTATAGCAGACTCTTCAGT
ATTCAGCCCATCAGCTTAGGTTTG -> TTCAGCCCATCAGCTTAGGTTTGC
ACACACTAGCCCTTGAGAAGTAGC -> CACACTAGCCCTTGAGAAGTAGCC
GGTAGGGGACTCCGATTAATTAGT -> GTAGGGGACTCCGATTAATTAGTA
TAGGGCTAGTTTAGCTCTGTACAT -> AGGGCTAGTTTAGCTCTGTACATG
ACGCGCTGGGATTATGGCGATGGT -> CGCGCTGGGATTATGGCGATGGTA
ATCGTCAACGTGTTGCCGTGGCGT -> TCGTCAACGTGTTGCCGTGGCGTG
CTTACACCATTTTTTCGCAGTACT -> TTACACCATTTTTTCGCAGTACTA
TCTCCTAGCCTAGAAGGGCGTTAC -> CTCCTAGCCTAGAAGGGCGTTACA
AAATCCTACGAACTAGAGCTGTCA -> AATCCTACGAACTAGAGCTGTCAG
ATGGGGTAACCTAAATTGCATGGT -> TGGGGTAACCTAAATTGCATGGTC
GGATGTCTGGTGATTAGATCCGGA -> GATGTCTGGTGATTAGATCCGGAG
TAAAAACATAGACATGACCGAATC -> AAAAACATAGACATGACCGAATCT
CCCATCAGCTTAGGTTTGCGCCGC -> CCATCAGCTTAGGTTTGCGCCGCG
GCGAGACAATGCGGTTACTCTCGC -> CGAGACAATGCGGTTACTCTCGCA
ACCAGATGGTTCGTAATTATCTTA -> CCAGATGGTTCGTAATTATCTTAC
CTCTTACCATTGGGCTGTACATCT -> TCTTACCATTGGGCTGTACATCTC
GCGGATGTCTGGTGATTAGATCCG -> CGGATGTCTGGTGATTAGATCCGG
GGATGCACGCGCTGGGATTATGGC -> GATGCACGCGCTGGGATTATGGCG
CTAGACTTACGGCTTACTTCCGGT -> TAGACTTACGGCTTACTTCCGGTA
CGCGGAAGGGTAGGGGACTCCGAT -> GCGGAAGGGTAGGGGACTCCGATT
AGTAGCCGTGTATCGTCAACGTGT -> GTAGCCGTGTATCGTCAACGTGTT
TTGAGATCTCGGGGCGAGCGCAAT -> TGAGATCTCGGGGCGAGCGCAATG
TGTTATCGGTCCATCTTCCTACGA -> GTTATCGGTCCATCTTCCTACGAG
ATCCGGAGTAGCCAAACCTTCTAG -> TCCGGAGTAGCCAAACCTTCTAGT
GTATCTTACGTAATGACAGTTAAC -> TATCTTACGTAATGACAGTTAACG
TGATATATCTGGTCCGGCCTTAGG -> GATATATCTGGTCCGGCCTTAGGG
GTGGCGTGTCTTTTCAACTATTGT -> TGGCGTGTCTTTTCAACTATTGTC
ATCTCTTACCATTGGGCTGTACAT -> TCTCTTACCATTGGGCTGTACATC
GCCTTTCTCGGAGAGAACCTGAAA -> CCTTTCTCGGAGAGAACCTGAAAC
AGATCTCGGGGCGAGCGCAATGCT -> GATCTCGGGGCGAGCGCAATGCTC
CCTAAGGACTGTGATTCAGCCCAT -> CTAAGGACTGTGATTCAGCCCATC
GGACCGCGGCTCGGAAGTCTGTTG -> GACCGCGGCTCGGAAGTCTGTTGT
CTTGAGAAGTAGCCGTGTATCGTC -> TTGAGAAGTAGCCGTGTATCGTCA
GTATAGCAGACTCTTCAGTATACT -> TATAGCAGACTCTTCAGTATACTA
GGTTACTCTCGCAGAGTCATGGAC -> GTTACTCTCGCAGAGTCATGGACA
GCTAACCAGCGTTCATCCTCACAG -> CTAACCAGCGTTCATCCTCACAGA
TAGACTTACGGCTTACTTCCGGTA -> AGACTTACGGCTTACTTCCGGTAA
CGTACACACTAGCCCTTGAGAAGT -> GTACACACTAGCCCTTGAGAAGTA
TAAGTCGATAACTTGTGCAGGATG -> AAGTCGATAACTTGTGCAGGATGA
CAACGTGCTAGCATTCTAGGCTAC -> AACGTGCTAGCATTCTAGGCTACC
TCCGACGCTTAGTGGATTTAGGGC -> CCGACGCTTAGTGGATTTAGGGCC
TTGGACCGCGGCTCGGAAGTCTGT -> TGGACCGCGGCTCGGAAGTCTGTT
CAGCTGGCGTAGCGATGCCATACA -> AGCTGGCGTAGCGATGCCATACAC
TAGTTTAGCTCTGTACATGGTGTT -> AGTTTAGCTCTGTACATGGTGTTG
ATGGCAGCTGGCGTAGCGATGCCA -> TGGCAGCTGGCGTAGCGATGCCAT
CCTGTAACAGACTGCAAGTATCTT -> CTGTAACAGACTGCAAGTATCTTA
ATATCTGGTCCGGCCTTAGGGCTA -> TATCTGGTCCGGCCTTAGGGCTAG
ACGGAACGACCCACGTATAGCAGA -> CGGAACGACCCACGTATAGCAGAC
TCGGGGCGAGCGCAATGCTCCTTC -> CGGGGCGAGCGCAATGCTCCTTCG
CTTCTTTCAGGATAAAAACATAGA -> TTCTTTCAGGATAAAAACATAGAC
GCAGCTGGCGTAGCGATGCCATAC -> CAGCTGGCGTAGCGATGCCATACA
CCGAATCTGTAGCATGTCCGACGC -> CGAATCTGTAGCATGTCCGACGCT
AACTAGAGCTGTCAGCGACACGGA -> ACTAGAGCTGTCAGCGACACGGAC
TTAATCCGGAGTAGCCAAACCTTC -> TAATCCGGAGTAGCCAAACCTTCT
TCTTACGTAATGACAGTTAACGGT -> CTTACGTAATGACAGTTAACGGTG
GATGTCTGGTGATTAGATCCGGAG -> ATGTCTGGTGATTAGATCCGGAGA
AGGATGATTCGGAGCCGAAATTCT -> GGATGATTCGGAGCCGAAATTCTC
TGTTGTGAGACGACTTGACCTTGA -> GTTGTGAGACGACTTGACCTTGAG
ATTCACGAAACTATTAGCGTGTAC -> TTCACGAAACTATTAGCGTGTACG
AGACCGCTGGGTCGTCCGCACGTG -> GACCGCTGGGTCGTCCGCACGTGA
CGGCCTTAGGGCTAGTTTAGCTCT -> GGCCTTAGGGCTAGTTTAGCTCTG
TATCTCTTACCATTGGGCTGTACA -> ATCTCTTACCATTGGGCTGTACAT
CGCAATGCTCCTTCGTAAAGAATT -> GCAATGCTCCTTCGTAAAGAATTC
TTTTGGCGCTCCACGGTTATCACC -> TTTGGCGCTCCACGGTTATCACCG
CGCAGTACTAGAGCTTAACAATAT -> GCAGTACTAGAGCTTAACAATATC
ACGGTTATCACCGTCCTGAGCTTG -> CGGTTATCACCGTCCTGAGCTTGC
GTCTGTTGTGAGACGACTTGACCT -> TCTGTTGTGAGACGACTTGACCTT
CCTAGCCTAGAAGGGCGTTACACC -> CTAGCCTAGAAGGGCGTTACACCA
TGGTCCGGCCTTAGGGCTAGTTTA -> GGTCCGGCCTTAGGGCTAGTTTAG
AAATTCTCAACTGTTAATCCGGAG -> AATTCTCAACTGTTAATCCGGAGT
GATTGAATGCTCCGCGGCTTGTCT -> ATTGAATGCTCCGCGGCTTGTCTT
CTGTCAGCGACACGGACCAGATGG -> TGTCAGCGACACGGACCAGATGGT
CGTTCATCCTCACAGATGACAGAC -> GTTCATCCTCACAGATGACAGACT
GTAACTCCTACGTAGGCAATTGGG -> TAACTCCTACGTAGGCAATTGGGA
AAAAACATAGACATGACCGAATCT -> AAAACATAGACATGACCGAATCTG
GCGACATACCTTGGACCGGTCGAC -> CGACATACCTTGGACCGGTCGACC
GGCTGGTGGAGACCGCTGGGTCGT -> GCTGGTGGAGACCGCTGGGTCGTC
CCTTGGACCGGTCGACCAGTCAAG -> CTTGGACCGGTCGACCAGTCAAGA
GATATATCTGGTCCGGCCTTAGGG -> ATATATCTGGTCCGGCCTTAGGGC
CCGAAATTCTCAACTGTTAATCCG -> CGAAATTCTCAACTGTTAATCCGG
GACAACGTGCTAGCATTCTAGGCT -> ACAACGTGCTAGCATTCTAGGCTA
GGCCCTACATTCTGGATGCACGCG -> GCCCTACATTCTGGATGCACGCGC
GAAACCGGTTTATGTACATATGGT -> AAACCGGTTTATGTACATATGGTA
AACGTGCTAGCATTCTAGGCTACC -> ACGTGCTAGCATTCTAGGCTACCC
ATATACCTTGGTAAGTCGATAACT -> TATACCTTGGTAAGTCGATAACTT
GGACCAGATGGTTCGTAATTATCT -> GACCAGATGGTTCGTAATTATCTT
GCTAGCATTCTAGGCTACCCAACG -> CTAGCATTCTAGGCTACCCAACGT
ACCATGTTCACACGCGTTTTGGCG -> CCATGTTCACACGCGTTTTGGCGC
GTCGTCGAGGTGCGTACTGATTTC -> TCGTCGAGGTGCGTACTGATTTCA
GGCAGCTGGCGTAGCGATGCCATA -> GCAGCTGGCGTAGCGATGCCATAC
TGTACATATGGTAGCTGCTCTTTA -> GTACATATGGTAGCTGCTCTTTAT
CGCTGGGTCGTCCGCACGTGATTG -> GCTGGGTCGTCCGCACGTGATTGA
TCTAGGCTACCCAACGTGATTGGC -> CTAGGCTACCCAACGTGATTGGCC
AGAACCTGAAACCGGTTTATGTAC -> GAACCTGAAACCGGTTTATGTACA
TGATTCGGAGCCGAAATTCTCAAC -> GATTCGGAGCCGAAATTCTCAACT
CTTACCATTGGGCTGTACATCTCC -> TTACCATTGGGCTGTACATCTCCT
TCTGGATGCACGCGCTGGGATTAT -> CTGGATGCACGCGCTGGGATTATG
CATGGACACGGGCGTTGGCATGAC -> ATGGACACGGGCGTTGGCATGACA
GGTCGACCAGTCAAGACGCAAGTG -> GTCGACCAGTCAAGACGCAAGTGT
GTTGCCTGTAACAGACTGCAAGTA -> TTGCCTGTAACAGACTGCAAGTAT
CTAGCCCTTGAGAAGTAGCCGTGT -> TAGCCCTTGAGAAGTAGCCGTGTA
CTGCAGCACGGAATGAGAAATCTA -> TGCAGCACGGAATGAGAAATCTAT
TGCACGCGCTGGGATTATGGCGAT -> GCACGCGCTGGGATTATGGCGATG
TCGCAGTACTAGAGCTTAACAATA -> CGCAGTACTAGAGCTTAACAATAT
TACGGCCTTTCTCGGAGAGAACCT -> ACGGCCTTTCTCGGAGAGAACCTG
TTAGGCACGGAACGACCCACGTAT -> TAGGCACGGAACGACCCACGTATA
CCCGTTATATCCTATGCATGCTTT -> CCGTTATATCCTATGCATGCTTTC
AATCTATGCAGAGACAACGTGCTA -> ATCTATGCAGAGACAACGTGCTAG
ACTCTCGCAGAGTCATGGACACGG -> CTCTCGCAGAGTCATGGACACGGG
GGTTAGATATGCATTCGCCCGAAA -> GTTAGATATGCATTCGCCCGAAAT
CTGGTCCGGCCTTAGGGCTAGTTT -> TGGTCCGGCCTTAGGGCTAGTTTA
TGACCTTGAGATCTCGGGGCGAGC -> GACCTTGAGATCTCGGGGCGAGCG
CCTGGGGAACCCATCATTAAAGTT -> CTGGGGAACCCATCATTAAAGTTA
TGTTCACACGCGTTTTGGCGCTCC -> GTTCACACGCGTTTTGGCGCTCCA
AATTAGTATTCCAAGGAGAGGGAG -> ATTAGTATTCCAAGGAGAGGGAGC
ATGCTCCTTCGTAAAGAATTCACG -> TGCTCCTTCGTAAAGAATTCACGA
GCGCGCGGAAGGGTAGGGGACTCC -> CGCGCGGAAGGGTAGGGGACTCCG
CACGAAACTATTAGCGTGTACGGC -> ACGAAACTATTAGCGTGTACGGCC
GGGCGTTGGCATGACAAAGGCGGA -> GGCGTTGGCATGACAAAGGCGGAT
CATGACAAAGGCGGATGTCTGGTG -> ATGACAAAGGCGGATGTCTGGTGA
GGTAATCCTAAGGACTGTGATTCA -> GTAATCCTAAGGACTGTGATTCAG
TTAGATCCGGAGATTGGACCGCGG -> TAGATCCGGAGATTGGACCGCGGC
GCTAAGGGGGCTGGTGGAGACCGC -> CTAAGGGGGCTGGTGGAGACCGCT
CTTCCTACGAGCCGACCTCTCCCA -> TTCCTACGAGCCGACCTCTCCCAC
GATCCGGAGATTGGACCGCGGCTC -> ATCCGGAGATTGGACCGCGGCTCG
ACACCACAGAATACGGCGTTTGTA -> CACCACAGAATACGGCGTTTGTAT
GCAAGTATCTTACGTAATGACAGT -> CAAGTATCTTACGTAATGACAGTT
TTTATTCCGGTATAGCACCTGTCT -> TTATTCCGGTATAGCACCTGTCTT
TCGTCGAGGTGCGTACTGATTTCA -> CGTCGAGGTGCGTACTGATTTCAC
GACTGTGATTCAGCCCATCAGCTT -> ACTGTGATTCAGCCCATCAGCTTA
GAGGTAACTCCTACGTAGGCAATT -> AGGTAACTCCTACGTAGGCAATTG
GTTCATCCTCACAGATGACAGACT -> TTCATCCTCACAGATGACAGACTA
GGCAATTGGGATGGCAGCTGGCGT -> GCAATTGGGATGGCAGCTGGCGTA
CAAGAGCCCTAATCGGAGCCAGGT -> AAGAGCCCTAATCGGAGCCAGGTT
CCCTTGAGAAGTAGCCGTGTATCG -> CCTTGAGAAGTAGCCGTGTATCGT
CACACCTTCTGCTACGGAGAAAGC -> ACACCTTCTGCTACGGAGAAAGCC
GCCCTAATCGGAGCCAGGTTGACG -> CCCTAATCGGAGCCAGGTTGACGC
TATGCCACTCCCGGGATCCTCCCG -> ATGCCACTCCCGGGATCCTCCCGC
TCCGATTAATTAGTATTCCAAGGA -> CCGATTAATTAGTATTCCAAGGAG
TCGCTAAGGGGGCTGGTGGAGACC -> CGCTAAGGGGGCTGGTGGAGACCG
TCGGAGCCGAAATTCTCAACTGTT -> CGGAGCCGAAATTCTCAACTGTTA
ACTCCGATTAATTAGTATTCCAAG -> CTCCGATTAATTAGTATTCCAAGG
CATGGGGTAACCTAAATTGCATGG -> ATGGGGTAACCTAAATTGCATGGT
CAGTCAAGACGCAAGTGTCGTCGC -> AGTCAAGACGCAAGTGTCGTCGCT
AATGCGGTTACTCTCGCAGAGTCA -> ATGCGGTTACTCTCGCAGAGTCAT
TTCACACCTTCTGCTACGGAGAAA -> TCACACCTTCTGCTACGGAGAAAG
TAGATGATCGACTGCGAGACAATG -> AGATGATCGACTGCGAGACAATGC
TTGAGAAGTAGCCGTGTATCGTCA -> TGAGAAGTAGCCGTGTATCGTCAA
GTATCGTCAACGTGTTGCCGTGGC -> TATCGTCAACGTGTTGCCGTGGCG
AGTATACTAAAATCCTACGAACTA -> GTATACTAAAATCCTACGAACTAG
TATTGTCACCATTTAGGCACGGAA -> ATTGTCACCATTTAGGCACGGAAC
ACGACTTGACCTTGAGATCTCGGG -> CGACTTGACCTTGAGATCTCGGGG
TTGCCTACTGCGACATACCTTGGA -> TGCCTACTGCGACATACCTTGGAC
CAGCCCATCAGCTTAGGTTTGCGC -> AGCCCATCAGCTTAGGTTTGCGCC
GTTTGTATATGGAATCAGTCGTCG -> TTTGTATATGGAATCAGTCGTCGA
TTCAACTATTGTCACCATTTAGGC -> TCAACTATTGTCACCATTTAGGCA
TCTCGCAGAGTCATGGACACGGGC -> CTCGCAGAGTCATGGACACGGGCG
ACGTAATGACAGTTAACGGTGTTA -> CGTAATGACAGTTAACGGTGTTAT
TTGGCCTGGGGAACCCATCATTAA -> TGGCCTGGGGAACCCATCATTAAA
AGACAATGCGGTTACTCTCGCAGA -> GACAATGCGGTTACTCTCGCAGAG
GGTTCGTAATTATCTTACACCATT -> GTTCGTAATTATCTTACACCATTT
ACCACAGAATACGGCGTTTGTATA -> CCACAGAATACGGCGTTTGTATAT
CTCCCGCCATGGGGTAACCTAAAT -> TCCCGCCATGGGGTAACCTAAATT
CGGAGCCAGGTTGACGCGCCGTAC -> GGAGCCAGGTTGACGCGCCGTACA
GAAATTCTCAACTGTTAATCCGGA -> AAATTCTCAACTGTTAATCCGGAG
TTGTGAGACGACTTGACCTTGAGA -> TGTGAGACGACTTGACCTTGAGAT
CTGCTCGCGAGTAAGACTAGATGA -> TGCTCGCGAGTAAGACTAGATGAT
GTAGCATGTCCGACGCTTAGTGGA -> TAGCATGTCCGACGCTTAGTGGAT
TGCGTACTGATTTCACACCTTCTG -> GCGTACTGATTTCACACCTTCTGC
GTTATGCCACTCCCGGGATCCTCC -> TTATGCCACTCCCGGGATCCTCCC
GCTTACTTCCGGTAACCCGGTAGT -> CTTACTTCCGGTAACCCGGTAGTA
GTTTATGTACATATGGTAGCTGCT -> TTTATGTACATATGGTAGCTGCTC
GACCCACGTATAGCAGACTCTTCA -> ACCCACGTATAGCAGACTCTTCAG
TGCGAGACAATGCGGTTACTCTCG -> GCGAGACAATGCGGTTACTCTCGC
CTACGAACTAGAGCTGTCAGCGAC -> TACGAACTAGAGCTGTCAGCGACA
ACTCCCGGGATCCTCCCGCCATGG -> CTCCCGGGATCCTCCCGCCATGGG
ATTGAATGCTCCGCGGCTTGTCTT -> TTGAATGCTCCGCGGCTTGTCTTC
CTGAGCTTGCCTACTGCGACATAC -> TGAGCTTGCCTACTGCGACATACC
